,filename,xmin,xmax,ymin,ymax,Time,Size,Type,Hand_Pixel_Width,Hand_Pixel_Height,Area,guantes,color
0,M_G_Mostrando_Amarillos_0_double_box1.jpg,218,461,464,715,M,G,train,243,251,60993,si,Amarillo
1,M_G_Mostrando_Amarillos_0_double_box2.jpg,617,865,432,598,M,G,train,248,166,41168,si,Amarillo
2,M_G_Mostrando_Amarillos_105_double_box1.jpg,875,1169,321,450,M,G,train,294,129,37926,si,Amarillo
3,M_G_Mostrando_Amarillos_105_double_box2.jpg,502,758,145,307,M,G,train,256,162,41472,si,Amarillo
4,M_G_Mostrando_Amarillos_114_double_box1.jpg,916,1151,285,463,M,G,train,235,178,41830,si,Amarillo
5,M_G_Mostrando_Amarillos_114_double_box2.jpg,599,807,260,430,M,G,train,208,170,35360,si,Amarillo
6,M_G_Mostrando_Amarillos_12_double_box1.jpg,336,531,288,494,M,G,train,195,206,40170,si,Amarillo
7,M_G_Mostrando_Amarillos_12_double_box2.jpg,505,757,324,489,M,G,train,252,165,41580,si,Amarillo
8,M_G_Mostrando_Amarillos_123_double_box1.jpg,319,485,38,213,M,G,train,166,175,29050,si,Amarillo
9,M_G_Mostrando_Amarillos_123_double_box2.jpg,1185,1354,130,293,M,G,train,169,163,27547,si,Amarillo
10,M_G_Mostrando_Amarillos_130_double_box1.jpg,962,1213,494,762,M,G,train,251,268,67268,si,Amarillo
11,M_G_Mostrando_Amarillos_130_double_box2.jpg,377,602,463,731,M,G,train,225,268,60300,si,Amarillo
12,M_G_Mostrando_Amarillos_132_double_box1.jpg,398,638,559,845,M,G,test,240,286,68640,si,Amarillo
13,M_G_Mostrando_Amarillos_132_double_box2.jpg,883,1150,611,888,M,G,test,267,277,73959,si,Amarillo
14,M_G_Mostrando_Amarillos_144_double_box1.jpg,1053,1446,180,480,M,G,test,393,300,117900,si,Amarillo
15,M_G_Mostrando_Amarillos_144_double_box2.jpg,3,342,100,378,M,G,test,339,278,94242,si,Amarillo
16,M_G_Mostrando_Amarillos_153_double_box1.jpg,1284,1468,342,534,M,G,test,184,192,35328,si,Amarillo
17,M_G_Mostrando_Amarillos_153_double_box2.jpg,318,487,239,386,M,G,test,169,147,24843,si,Amarillo
18,M_G_Mostrando_Amarillos_164_double_box1.jpg,825,1037,143,319,M,G,test,212,176,37312,si,Amarillo
19,M_G_Mostrando_Amarillos_164_double_box2.jpg,731,884,251,357,M,G,test,153,106,16218,si,Amarillo
20,M_G_Mostrando_Amarillos_175_double_box1.jpg,709,835,182,306,M,G,test,126,124,15624,si,Amarillo
21,M_G_Mostrando_Amarillos_175_double_box2.jpg,782,941,208,347,M,G,test,159,139,22101,si,Amarillo
22,M_G_Mostrando_Amarillos_186_single_box.jpg,407,631,280,483,M,G,test,224,203,45472,si,Amarillo
23,M_G_Mostrando_Amarillos_24_double_box1.jpg,687,996,577,917,M,G,train,309,340,105060,si,Amarillo
24,M_G_Mostrando_Amarillos_24_double_box2.jpg,424,702,529,913,M,G,train,278,384,106752,si,Amarillo
25,M_G_Mostrando_Amarillos_36_double_box1.jpg,1169,1442,135,316,M,G,train,273,181,49413,si,Amarillo
26,M_G_Mostrando_Amarillos_36_double_box2.jpg,302,565,40,235,M,G,train,263,195,51285,si,Amarillo
27,M_G_Mostrando_Amarillos_45_double_box1.jpg,892,1136,332,498,M,G,train,244,166,40504,si,Amarillo
28,M_G_Mostrando_Amarillos_45_double_box2.jpg,1370,1526,321,485,M,G,train,156,164,25584,si,Amarillo
29,M_G_Mostrando_Amarillos_56_double_box1.jpg,50,354,86,258,M,G,train,304,172,52288,si,Amarillo
30,M_G_Mostrando_Amarillos_56_double_box2.jpg,523,879,132,320,M,G,train,356,188,66928,si,Amarillo
31,M_G_Mostrando_Amarillos_65_double_box1.jpg,728,1036,352,591,M,G,train,308,239,73612,si,Amarillo
32,M_G_Mostrando_Amarillos_65_double_box2.jpg,378,566,308,542,M,G,train,188,234,43992,si,Amarillo
33,M_G_Mostrando_Amarillos_74_double_box1.jpg,324,534,269,465,M,G,train,210,196,41160,si,Amarillo
34,M_G_Mostrando_Amarillos_74_double_box2.jpg,997,1277,436,726,M,G,train,280,290,81200,si,Amarillo
35,M_G_Mostrando_Amarillos_85_double_box1.jpg,1198,1439,175,362,M,G,train,241,187,45067,si,Amarillo
36,M_G_Mostrando_Amarillos_85_double_box2.jpg,154,387,49,192,M,G,train,233,143,33319,si,Amarillo
37,M_G_Mostrando_Amarillos_96_double_box1.jpg,98,389,76,280,M,G,train,291,204,59364,si,Amarillo
38,M_G_Mostrando_Amarillos_96_double_box2.jpg,1242,1517,182,375,M,G,train,275,193,53075,si,Amarillo
39,M_G_Trabajando_Amarillos_101_double_box1.jpg,668,770,242,422,M,G,train,102,180,18360,si,Amarillo
40,M_G_Trabajando_Amarillos_101_double_box2.jpg,742,938,291,422,M,G,train,196,131,25676,si,Amarillo
41,M_G_Trabajando_Amarillos_112_double_box1.jpg,673,899,295,615,M,G,train,226,320,72320,si,Amarillo
42,M_G_Trabajando_Amarillos_112_double_box2.jpg,1169,1354,317,639,M,G,train,185,322,59570,si,Amarillo
43,M_G_Trabajando_Amarillos_123_double_box1.jpg,729,919,170,316,M,G,train,190,146,27740,si,Amarillo
44,M_G_Trabajando_Amarillos_123_double_box2.jpg,602,762,160,305,M,G,train,160,145,23200,si,Amarillo
45,M_G_Trabajando_Amarillos_134_double_box1.jpg,703,928,190,345,M,G,train,225,155,34875,si,Amarillo
46,M_G_Trabajando_Amarillos_134_double_box2.jpg,522,694,217,309,M,G,train,172,92,15824,si,Amarillo
47,M_G_Trabajando_Amarillos_145_double_box1.jpg,1362,1600,430,709,M,G,train,238,279,66402,si,Amarillo
48,M_G_Trabajando_Amarillos_145_double_box2.jpg,1302,1465,287,401,M,G,train,163,114,18582,si,Amarillo
49,M_G_Trabajando_Amarillos_148_double_box1.jpg,1401,1615,446,688,M,G,test,214,242,51788,si,Amarillo
50,M_G_Trabajando_Amarillos_148_double_box2.jpg,1398,1565,317,442,M,G,test,167,125,20875,si,Amarillo
51,M_G_Trabajando_Amarillos_159_double_box1.jpg,903,1209,304,556,M,G,test,306,252,77112,si,Amarillo
52,M_G_Trabajando_Amarillos_159_double_box2.jpg,1324,1514,326,515,M,G,test,190,189,35910,si,Amarillo
53,M_G_Trabajando_Amarillos_169_double_box1.jpg,1175,1347,294,472,M,G,test,172,178,30616,si,Amarillo
54,M_G_Trabajando_Amarillos_169_double_box2.jpg,846,1109,276,415,M,G,test,263,139,36557,si,Amarillo
55,M_G_Trabajando_Amarillos_18_double_box1.jpg,654,870,292,509,M,G,train,216,217,46872,si,Amarillo
56,M_G_Trabajando_Amarillos_18_double_box2.jpg,345,501,310,527,M,G,train,156,217,33852,si,Amarillo
57,M_G_Trabajando_Amarillos_180_double_box1.jpg,1087,1231,187,326,M,G,test,144,139,20016,si,Amarillo
58,M_G_Trabajando_Amarillos_180_double_box2.jpg,883,1085,193,359,M,G,test,202,166,33532,si,Amarillo
59,M_G_Trabajando_Amarillos_190_double_box1.jpg,857,1039,244,402,M,G,test,182,158,28756,si,Amarillo
60,M_G_Trabajando_Amarillos_190_double_box2.jpg,1156,1371,272,475,M,G,test,215,203,43645,si,Amarillo
61,M_G_Trabajando_Amarillos_200_double_box1.jpg,776,883,171,356,M,G,test,107,185,19795,si,Amarillo
62,M_G_Trabajando_Amarillos_200_double_box2.jpg,861,990,152,348,M,G,test,129,196,25284,si,Amarillo
63,M_G_Trabajando_Amarillos_27_double_box1.jpg,580,850,390,657,M,G,train,270,267,72090,si,Amarillo
64,M_G_Trabajando_Amarillos_27_double_box2.jpg,344,604,404,655,M,G,train,260,251,65260,si,Amarillo
65,M_G_Trabajando_Amarillos_36_double_box1.jpg,797,1021,318,495,M,G,train,224,177,39648,si,Amarillo
66,M_G_Trabajando_Amarillos_36_double_box2.jpg,581,776,248,428,M,G,train,195,180,35100,si,Amarillo
67,M_G_Trabajando_Amarillos_45_double_box1.jpg,909,1209,163,313,M,G,train,300,150,45000,si,Amarillo
68,M_G_Trabajando_Amarillos_45_double_box2.jpg,1267,1419,196,314,M,G,train,152,118,17936,si,Amarillo
69,M_G_Trabajando_Amarillos_54_double_box1.jpg,1215,1429,311,567,M,G,train,214,256,54784,si,Amarillo
70,M_G_Trabajando_Amarillos_54_double_box2.jpg,1398,1646,313,489,M,G,train,248,176,43648,si,Amarillo
71,M_G_Trabajando_Amarillos_63_double_box1.jpg,697,968,289,525,M,G,train,271,236,63956,si,Amarillo
72,M_G_Trabajando_Amarillos_63_double_box2.jpg,1178,1395,302,561,M,G,train,217,259,56203,si,Amarillo
73,M_G_Trabajando_Amarillos_72_double_box1.jpg,747,883,167,306,M,G,train,136,139,18904,si,Amarillo
74,M_G_Trabajando_Amarillos_72_double_box2.jpg,896,1091,205,352,M,G,train,195,147,28665,si,Amarillo
75,M_G_Trabajando_Amarillos_81_double_box1.jpg,831,1103,156,294,M,G,train,272,138,37536,si,Amarillo
76,M_G_Trabajando_Amarillos_81_double_box2.jpg,737,826,222,358,M,G,train,89,136,12104,si,Amarillo
77,M_G_Trabajando_Amarillos_9_double_box1.jpg,746,929,47,241,M,G,train,183,194,35502,si,Amarillo
78,M_G_Trabajando_Amarillos_9_double_box2.jpg,874,1014,158,311,M,G,train,140,153,21420,si,Amarillo
79,M_G_Trabajando_Amarillos_90_double_box1.jpg,1144,1340,273,478,M,G,train,196,205,40180,si,Amarillo
80,M_G_Trabajando_Amarillos_90_double_box2.jpg,617,777,171,313,M,G,train,160,142,22720,si,Amarillo
81,M_P_Mostrando_Amarillos_0_single_box.jpg,888,958,246,297,M,P,train,70,51,3570,si,Amarillo
82,M_P_Mostrando_Amarillos_10_single_box.jpg,786,825,224,273,M,P,train,39,49,1911,si,Amarillo
83,M_P_Mostrando_Amarillos_100_double_box1.jpg,1039,1126,152,213,M,P,train,87,61,5307,si,Amarillo
84,M_P_Mostrando_Amarillos_100_double_box2.jpg,871,943,215,269,M,P,train,72,54,3888,si,Amarillo
85,M_P_Mostrando_Amarillos_110_double_box1.jpg,988,1050,244,296,M,P,train,62,52,3224,si,Amarillo
86,M_P_Mostrando_Amarillos_110_double_box2.jpg,794,848,259,305,M,P,train,54,46,2484,si,Amarillo
87,M_P_Mostrando_Amarillos_120_double_box1.jpg,892,956,273,327,M,P,train,64,54,3456,si,Amarillo
88,M_P_Mostrando_Amarillos_120_double_box2.jpg,724,804,281,330,M,P,train,80,49,3920,si,Amarillo
89,M_P_Mostrando_Amarillos_130_single_box.jpg,898,956,271,311,M,P,train,58,40,2320,si,Amarillo
90,M_P_Mostrando_Amarillos_140_double_box1.jpg,1071,1140,180,242,M,P,train,69,62,4278,si,Amarillo
91,M_P_Mostrando_Amarillos_140_double_box2.jpg,744,818,179,236,M,P,train,74,57,4218,si,Amarillo
92,M_P_Mostrando_Amarillos_150_double_box1.jpg,940,1013,189,249,M,P,train,73,60,4380,si,Amarillo
93,M_P_Mostrando_Amarillos_150_double_box2.jpg,1262,1323,168,233,M,P,train,61,65,3965,si,Amarillo
94,M_P_Mostrando_Amarillos_160_double_box1.jpg,1222,1277,299,359,M,P,train,55,60,3300,si,Amarillo
95,M_P_Mostrando_Amarillos_160_double_box2.jpg,1138,1179,304,354,M,P,train,41,50,2050,si,Amarillo
96,M_P_Mostrando_Amarillos_170_double_box1.jpg,1389,1478,92,141,M,P,train,89,49,4361,si,Amarillo
97,M_P_Mostrando_Amarillos_170_double_box2.jpg,1331,1404,114,168,M,P,train,73,54,3942,si,Amarillo
98,M_P_Mostrando_Amarillos_180_double_box1.jpg,1383,1437,139,191,M,P,train,54,52,2808,si,Amarillo
99,M_P_Mostrando_Amarillos_180_double_box2.jpg,1264,1321,199,265,M,P,train,57,66,3762,si,Amarillo
100,M_P_Mostrando_Amarillos_182_double_box1.jpg,1372,1421,164,214,M,P,test,49,50,2450,si,Amarillo
101,M_P_Mostrando_Amarillos_182_double_box2.jpg,1246,1304,202,261,M,P,test,58,59,3422,si,Amarillo
102,M_P_Mostrando_Amarillos_193_double_box1.jpg,968,1051,165,236,M,P,test,83,71,5893,si,Amarillo
103,M_P_Mostrando_Amarillos_193_double_box2.jpg,1201,1275,201,279,M,P,test,74,78,5772,si,Amarillo
104,M_P_Mostrando_Amarillos_20_single_box.jpg,996,1055,173,225,M,P,train,59,52,3068,si,Amarillo
105,M_P_Mostrando_Amarillos_204_double_box1.jpg,884,926,198,270,M,P,test,42,72,3024,si,Amarillo
106,M_P_Mostrando_Amarillos_204_double_box2.jpg,929,1008,82,146,M,P,test,79,64,5056,si,Amarillo
107,M_P_Mostrando_Amarillos_215_double_box1.jpg,1025,1093,199,250,M,P,test,68,51,3468,si,Amarillo
108,M_P_Mostrando_Amarillos_215_double_box2.jpg,736,815,198,239,M,P,test,79,41,3239,si,Amarillo
109,M_P_Mostrando_Amarillos_226_double_box1.jpg,895,948,171,226,M,P,test,53,55,2915,si,Amarillo
110,M_P_Mostrando_Amarillos_226_double_box2.jpg,796,852,188,235,M,P,test,56,47,2632,si,Amarillo
111,M_P_Mostrando_Amarillos_237_single_box.jpg,891,963,192,251,M,P,test,72,59,4248,si,Amarillo
112,M_P_Mostrando_Amarillos_249_single_box.jpg,890,938,25,96,M,P,test,48,71,3408,si,Amarillo
113,M_P_Mostrando_Amarillos_258_single_box.jpg,968,1011,226,279,M,P,test,43,53,2279,si,Amarillo
114,M_P_Mostrando_Amarillos_30_double_box1.jpg,765,827,238,288,M,P,train,62,50,3100,si,Amarillo
115,M_P_Mostrando_Amarillos_30_double_box2.jpg,837,918,247,300,M,P,train,81,53,4293,si,Amarillo
116,M_P_Mostrando_Amarillos_40_double_box1.jpg,779,838,284,334,M,P,train,59,50,2950,si,Amarillo
117,M_P_Mostrando_Amarillos_40_double_box2.jpg,693,758,286,342,M,P,train,65,56,3640,si,Amarillo
118,M_P_Mostrando_Amarillos_50_double_box1.jpg,965,1032,268,311,M,P,train,67,43,2881,si,Amarillo
119,M_P_Mostrando_Amarillos_50_double_box2.jpg,589,669,187,250,M,P,train,80,63,5040,si,Amarillo
120,M_P_Mostrando_Amarillos_60_double_box1.jpg,948,1011,121,225,M,P,train,63,104,6552,si,Amarillo
121,M_P_Mostrando_Amarillos_60_double_box2.jpg,656,706,96,176,M,P,train,50,80,4000,si,Amarillo
122,M_P_Mostrando_Amarillos_70_single_box.jpg,746,825,166,224,M,P,train,79,58,4582,si,Amarillo
123,M_P_Mostrando_Amarillos_80_double_box1.jpg,662,741,251,316,M,P,train,79,65,5135,si,Amarillo
124,M_P_Mostrando_Amarillos_80_double_box2.jpg,602,657,129,183,M,P,train,55,54,2970,si,Amarillo
125,M_P_Mostrando_Amarillos_91_double_box1.jpg,844,923,230,285,M,P,train,79,55,4345,si,Amarillo
126,M_P_Mostrando_Amarillos_91_double_box2.jpg,637,700,254,313,M,P,train,63,59,3717,si,Amarillo
127,M_P_Trabajando_Amarillos_0_single_box.jpg,871,925,203,233,M,P,train,54,30,1620,si,Amarillo
128,M_P_Trabajando_Amarillos_101_double_box1.jpg,808,884,237,267,M,P,train,76,30,2280,si,Amarillo
129,M_P_Trabajando_Amarillos_101_double_box2.jpg,845,899,263,296,M,P,train,54,33,1782,si,Amarillo
130,M_P_Trabajando_Amarillos_11_double_box1.jpg,854,905,252,318,M,P,train,51,66,3366,si,Amarillo
131,M_P_Trabajando_Amarillos_11_double_box2.jpg,789,827,246,301,M,P,train,38,55,2090,si,Amarillo
132,M_P_Trabajando_Amarillos_110_double_box1.jpg,770,830,259,312,M,P,train,60,53,3180,si,Amarillo
133,M_P_Trabajando_Amarillos_110_double_box2.jpg,854,903,257,328,M,P,train,49,71,3479,si,Amarillo
134,M_P_Trabajando_Amarillos_121_double_box1.jpg,813,885,267,315,M,P,train,72,48,3456,si,Amarillo
135,M_P_Trabajando_Amarillos_121_double_box2.jpg,858,907,189,236,M,P,train,49,47,2303,si,Amarillo
136,M_P_Trabajando_Amarillos_132_single_box.jpg,824,881,252,302,M,P,train,57,50,2850,si,Amarillo
137,M_P_Trabajando_Amarillos_133_double_box1.jpg,844,891,228,292,M,P,train,47,64,3008,si,Amarillo
138,M_P_Trabajando_Amarillos_133_double_box2.jpg,805,851,271,311,M,P,train,46,40,1840,si,Amarillo
139,M_P_Trabajando_Amarillos_144_double_box1.jpg,869,915,269,302,M,P,train,46,33,1518,si,Amarillo
140,M_P_Trabajando_Amarillos_144_double_box2.jpg,764,816,249,308,M,P,train,52,59,3068,si,Amarillo
141,M_P_Trabajando_Amarillos_155_single_box.jpg,856,926,217,251,M,P,train,70,34,2380,si,Amarillo
142,M_P_Trabajando_Amarillos_156_single_box.jpg,869,940,218,264,M,P,test,71,46,3266,si,Amarillo
143,M_P_Trabajando_Amarillos_165_double_box1.jpg,856,928,238,295,M,P,test,72,57,4104,si,Amarillo
144,M_P_Trabajando_Amarillos_165_double_box2.jpg,932,971,239,298,M,P,test,39,59,2301,si,Amarillo
145,M_P_Trabajando_Amarillos_174_single_box.jpg,849,931,225,268,M,P,test,82,43,3526,si,Amarillo
146,M_P_Trabajando_Amarillos_175_single_box.jpg,857,929,231,265,M,P,test,72,34,2448,si,Amarillo
147,M_P_Trabajando_Amarillos_185_double_box1.jpg,857,926,245,295,M,P,test,69,50,3450,si,Amarillo
148,M_P_Trabajando_Amarillos_185_double_box2.jpg,939,961,251,295,M,P,test,22,44,968,si,Amarillo
149,M_P_Trabajando_Amarillos_194_double_box1.jpg,853,933,242,296,M,P,test,80,54,4320,si,Amarillo
150,M_P_Trabajando_Amarillos_194_double_box2.jpg,929,968,239,276,M,P,test,39,37,1443,si,Amarillo
151,M_P_Trabajando_Amarillos_203_double_box1.jpg,834,894,243,280,M,P,test,60,37,2220,si,Amarillo
152,M_P_Trabajando_Amarillos_203_double_box2.jpg,885,929,264,294,M,P,test,44,30,1320,si,Amarillo
153,M_P_Trabajando_Amarillos_212_double_box1.jpg,839,894,213,260,M,P,test,55,47,2585,si,Amarillo
154,M_P_Trabajando_Amarillos_212_double_box2.jpg,807,839,219,266,M,P,test,32,47,1504,si,Amarillo
155,M_P_Trabajando_Amarillos_221_double_box1.jpg,797,858,244,276,M,P,test,61,32,1952,si,Amarillo
156,M_P_Trabajando_Amarillos_221_double_box2.jpg,853,909,239,273,M,P,test,56,34,1904,si,Amarillo
157,M_P_Trabajando_Amarillos_23_double_box1.jpg,794,856,277,301,M,P,train,62,24,1488,si,Amarillo
158,M_P_Trabajando_Amarillos_23_double_box2.jpg,949,1024,268,329,M,P,train,75,61,4575,si,Amarillo
159,M_P_Trabajando_Amarillos_34_double_box1.jpg,988,1026,252,291,M,P,train,38,39,1482,si,Amarillo
160,M_P_Trabajando_Amarillos_34_double_box2.jpg,721,791,257,307,M,P,train,70,50,3500,si,Amarillo
161,M_P_Trabajando_Amarillos_45_double_box1.jpg,786,865,247,284,M,P,train,79,37,2923,si,Amarillo
162,M_P_Trabajando_Amarillos_45_double_box2.jpg,690,759,259,315,M,P,train,69,56,3864,si,Amarillo
163,M_P_Trabajando_Amarillos_56_double_box1.jpg,768,826,255,301,M,P,train,58,46,2668,si,Amarillo
164,M_P_Trabajando_Amarillos_56_double_box2.jpg,703,740,259,294,M,P,train,37,35,1295,si,Amarillo
165,M_P_Trabajando_Amarillos_65_double_box1.jpg,877,929,258,283,M,P,train,52,25,1300,si,Amarillo
166,M_P_Trabajando_Amarillos_65_double_box2.jpg,786,848,264,301,M,P,train,62,37,2294,si,Amarillo
167,M_P_Trabajando_Amarillos_74_double_box1.jpg,812,868,214,250,M,P,train,56,36,2016,si,Amarillo
168,M_P_Trabajando_Amarillos_74_double_box2.jpg,877,914,231,270,M,P,train,37,39,1443,si,Amarillo
169,M_P_Trabajando_Amarillos_83_double_box1.jpg,794,837,243,292,M,P,train,43,49,2107,si,Amarillo
170,M_P_Trabajando_Amarillos_83_double_box2.jpg,841,882,251,286,M,P,train,41,35,1435,si,Amarillo
171,M_P_Trabajando_Amarillos_92_double_box1.jpg,850,897,231,285,M,P,train,47,54,2538,si,Amarillo
172,M_P_Trabajando_Amarillos_92_double_box2.jpg,766,809,257,298,M,P,train,43,41,1763,si,Amarillo
173,N_G_Mostrando_Amarillos_0_single_box.jpg,872,1009,301,406,N,G,train,137,105,14385,si,Amarillo
174,N_G_Mostrando_Amarillos_10_single_box.jpg,956,1074,347,412,N,G,train,118,65,7670,si,Amarillo
175,N_G_Mostrando_Amarillos_100_double_box1.jpg,970,1105,277,394,N,G,test,135,117,15795,si,Amarillo
176,N_G_Mostrando_Amarillos_100_double_box2.jpg,808,987,207,363,N,G,test,179,156,27924,si,Amarillo
177,N_G_Mostrando_Amarillos_103_double_box1.jpg,931,1075,269,385,N,G,test,144,116,16704,si,Amarillo
178,N_G_Mostrando_Amarillos_103_double_box2.jpg,737,944,208,348,N,G,test,207,140,28980,si,Amarillo
179,N_G_Mostrando_Amarillos_20_single_box.jpg,850,1007,308,403,N,G,train,157,95,14915,si,Amarillo
180,N_G_Mostrando_Amarillos_30_double_box1.jpg,1027,1236,306,535,N,G,train,209,229,47861,si,Amarillo
181,N_G_Mostrando_Amarillos_30_double_box2.jpg,695,898,255,480,N,G,train,203,225,45675,si,Amarillo
182,N_G_Mostrando_Amarillos_40_double_box1.jpg,944,1142,590,800,N,G,train,198,210,41580,si,Amarillo
183,N_G_Mostrando_Amarillos_40_double_box2.jpg,700,884,571,781,N,G,train,184,210,38640,si,Amarillo
184,N_G_Mostrando_Amarillos_50_double_box1.jpg,377,615,351,591,N,G,train,238,240,57120,si,Amarillo
185,N_G_Mostrando_Amarillos_50_double_box2.jpg,1181,1420,385,638,N,G,train,239,253,60467,si,Amarillo
186,N_G_Mostrando_Amarillos_60_double_box1.jpg,511,650,305,511,N,G,train,139,206,28634,si,Amarillo
187,N_G_Mostrando_Amarillos_60_double_box2.jpg,1122,1277,323,537,N,G,train,155,214,33170,si,Amarillo
188,N_G_Mostrando_Amarillos_70_double_box1.jpg,953,1174,491,824,N,G,train,221,333,73593,si,Amarillo
189,N_G_Mostrando_Amarillos_70_double_box2.jpg,539,708,552,843,N,G,train,169,291,49179,si,Amarillo
190,N_G_Mostrando_Amarillos_84_double_box1.jpg,1342,1493,321,513,N,G,test,151,192,28992,si,Amarillo
191,N_G_Mostrando_Amarillos_84_double_box2.jpg,284,434,253,441,N,G,test,150,188,28200,si,Amarillo
192,N_G_Mostrando_Amarillos_90_double_box1.jpg,437,591,279,408,N,G,test,154,129,19866,si,Amarillo
193,N_G_Mostrando_Amarillos_90_double_box2.jpg,1284,1410,316,452,N,G,test,126,136,17136,si,Amarillo
194,N_G_Trabajando_Amarillos_0_single_box.jpg,698,780,307,392,N,G,train,82,85,6970,si,Amarillo
195,N_G_Trabajando_Amarillos_10_single_box.jpg,658,777,293,390,N,G,train,119,97,11543,si,Amarillo
196,N_G_Trabajando_Amarillos_100_double_box1.jpg,794,936,202,418,N,G,train,142,216,30672,si,Amarillo
197,N_G_Trabajando_Amarillos_100_double_box2.jpg,969,1149,332,478,N,G,train,180,146,26280,si,Amarillo
198,N_G_Trabajando_Amarillos_110_single_box.jpg,603,831,327,481,N,G,train,228,154,35112,si,Amarillo
199,N_G_Trabajando_Amarillos_120_double_box1.jpg,1016,1188,304,462,N,G,train,172,158,27176,si,Amarillo
200,N_G_Trabajando_Amarillos_120_double_box2.jpg,599,749,236,362,N,G,train,150,126,18900,si,Amarillo
201,N_G_Trabajando_Amarillos_130_double_box1.jpg,1056,1272,610,883,N,G,train,216,273,58968,si,Amarillo
202,N_G_Trabajando_Amarillos_130_double_box2.jpg,1134,1281,326,489,N,G,train,147,163,23961,si,Amarillo
203,N_G_Trabajando_Amarillos_140_double_box1.jpg,857,1130,271,448,N,G,train,273,177,48321,si,Amarillo
204,N_G_Trabajando_Amarillos_140_double_box2.jpg,1095,1263,227,400,N,G,train,168,173,29064,si,Amarillo
205,N_G_Trabajando_Amarillos_150_double_box1.jpg,938,1180,312,492,N,G,train,242,180,43560,si,Amarillo
206,N_G_Trabajando_Amarillos_150_double_box2.jpg,1129,1289,289,447,N,G,train,160,158,25280,si,Amarillo
207,N_G_Trabajando_Amarillos_160_single_box.jpg,941,1217,270,461,N,G,train,276,191,52716,si,Amarillo
208,N_G_Trabajando_Amarillos_170_double_box1.jpg,863,1092,316,464,N,G,train,229,148,33892,si,Amarillo
209,N_G_Trabajando_Amarillos_170_double_box2.jpg,1090,1227,263,372,N,G,train,137,109,14933,si,Amarillo
210,N_G_Trabajando_Amarillos_180_double_box1.jpg,1034,1208,500,796,N,G,train,174,296,51504,si,Amarillo
211,N_G_Trabajando_Amarillos_180_double_box2.jpg,725,930,471,765,N,G,train,205,294,60270,si,Amarillo
212,N_G_Trabajando_Amarillos_190_double_box1.jpg,440,672,550,822,N,G,train,232,272,63104,si,Amarillo
213,N_G_Trabajando_Amarillos_190_double_box2.jpg,722,989,434,725,N,G,train,267,291,77697,si,Amarillo
214,N_G_Trabajando_Amarillos_20_double_box1.jpg,592,853,444,755,N,G,train,261,311,81171,si,Amarillo
215,N_G_Trabajando_Amarillos_20_double_box2.jpg,428,585,417,674,N,G,train,157,257,40349,si,Amarillo
216,N_G_Trabajando_Amarillos_200_double_box1.jpg,830,1027,260,483,N,G,train,197,223,43931,si,Amarillo
217,N_G_Trabajando_Amarillos_200_double_box2.jpg,623,869,209,581,N,G,train,246,372,91512,si,Amarillo
218,N_G_Trabajando_Amarillos_210_double_box1.jpg,658,802,366,524,N,G,train,144,158,22752,si,Amarillo
219,N_G_Trabajando_Amarillos_210_double_box2.jpg,959,1138,343,493,N,G,train,179,150,26850,si,Amarillo
220,N_G_Trabajando_Amarillos_220_double_box1.jpg,602,849,270,505,N,G,train,247,235,58045,si,Amarillo
221,N_G_Trabajando_Amarillos_220_double_box2.jpg,295,468,376,557,N,G,train,173,181,31313,si,Amarillo
222,N_G_Trabajando_Amarillos_229_double_box1.jpg,521,769,286,475,N,G,test,248,189,46872,si,Amarillo
223,N_G_Trabajando_Amarillos_229_double_box2.jpg,228,394,303,519,N,G,test,166,216,35856,si,Amarillo
224,N_G_Trabajando_Amarillos_230_double_box1.jpg,565,831,266,466,N,G,test,266,200,53200,si,Amarillo
225,N_G_Trabajando_Amarillos_230_double_box2.jpg,210,389,387,613,N,G,test,179,226,40454,si,Amarillo
226,N_G_Trabajando_Amarillos_240_double_box1.jpg,399,568,421,642,N,G,test,169,221,37349,si,Amarillo
227,N_G_Trabajando_Amarillos_240_double_box2.jpg,818,1040,308,453,N,G,test,222,145,32190,si,Amarillo
228,N_G_Trabajando_Amarillos_250_double_box1.jpg,821,1033,377,542,N,G,test,212,165,34980,si,Amarillo
229,N_G_Trabajando_Amarillos_250_double_box2.jpg,610,751,312,527,N,G,test,141,215,30315,si,Amarillo
230,N_G_Trabajando_Amarillos_260_double_box1.jpg,457,669,314,483,N,G,test,212,169,35828,si,Amarillo
231,N_G_Trabajando_Amarillos_260_double_box2.jpg,351,495,251,421,N,G,test,144,170,24480,si,Amarillo
232,N_G_Trabajando_Amarillos_270_double_box1.jpg,663,883,159,374,N,G,test,220,215,47300,si,Amarillo
233,N_G_Trabajando_Amarillos_270_double_box2.jpg,890,1023,284,376,N,G,test,133,92,12236,si,Amarillo
234,N_G_Trabajando_Amarillos_280_single_box.jpg,904,1135,146,280,N,G,test,231,134,30954,si,Amarillo
235,N_G_Trabajando_Amarillos_290_double_box1.jpg,624,787,338,497,N,G,test,163,159,25917,si,Amarillo
236,N_G_Trabajando_Amarillos_290_double_box2.jpg,1042,1248,339,496,N,G,test,206,157,32342,si,Amarillo
237,N_G_Trabajando_Amarillos_30_double_box1.jpg,413,695,448,685,N,G,train,282,237,66834,si,Amarillo
238,N_G_Trabajando_Amarillos_30_double_box2.jpg,212,358,270,500,N,G,train,146,230,33580,si,Amarillo
239,N_G_Trabajando_Amarillos_300_double_box1.jpg,611,804,328,531,N,G,test,193,203,39179,si,Amarillo
240,N_G_Trabajando_Amarillos_300_double_box2.jpg,1032,1191,138,292,N,G,test,159,154,24486,si,Amarillo
241,N_G_Trabajando_Amarillos_310_double_box1.jpg,931,1110,318,510,N,G,test,179,192,34368,si,Amarillo
242,N_G_Trabajando_Amarillos_310_double_box2.jpg,630,824,227,386,N,G,test,194,159,30846,si,Amarillo
243,N_G_Trabajando_Amarillos_40_single_box.jpg,508,709,319,577,N,G,train,201,258,51858,si,Amarillo
244,N_G_Trabajando_Amarillos_50_single_box.jpg,946,1179,398,580,N,G,train,233,182,42406,si,Amarillo
245,N_G_Trabajando_Amarillos_60_double_box1.jpg,801,1034,358,564,N,G,train,233,206,47998,si,Amarillo
246,N_G_Trabajando_Amarillos_60_double_box2.jpg,1148,1336,331,585,N,G,train,188,254,47752,si,Amarillo
247,N_G_Trabajando_Amarillos_70_single_box.jpg,780,1059,187,347,N,G,train,279,160,44640,si,Amarillo
248,N_G_Trabajando_Amarillos_80_double_box1.jpg,454,623,408,640,N,G,train,169,232,39208,si,Amarillo
249,N_G_Trabajando_Amarillos_80_double_box2.jpg,544,794,537,836,N,G,train,250,299,74750,si,Amarillo
250,N_G_Trabajando_Amarillos_90_double_box1.jpg,881,1069,276,420,N,G,train,188,144,27072,si,Amarillo
251,N_G_Trabajando_Amarillos_90_double_box2.jpg,715,854,160,259,N,G,train,139,99,13761,si,Amarillo
252,N_P_Mostrando_Amarillos_0_double_box1.jpg,1071,1130,251,299,N,P,train,59,48,2832,si,Amarillo
253,N_P_Mostrando_Amarillos_0_double_box2.jpg,962,1016,249,292,N,P,train,54,43,2322,si,Amarillo
254,N_P_Mostrando_Amarillos_10_double_box1.jpg,1162,1230,272,329,N,P,train,68,57,3876,si,Amarillo
255,N_P_Mostrando_Amarillos_10_double_box2.jpg,831,912,269,322,N,P,train,81,53,4293,si,Amarillo
256,N_P_Mostrando_Amarillos_100_double_box1.jpg,999,1052,3,111,N,P,train,53,108,5724,si,Amarillo
257,N_P_Mostrando_Amarillos_100_double_box2.jpg,1092,1155,6,103,N,P,train,63,97,6111,si,Amarillo
258,N_P_Mostrando_Amarillos_110_single_box.jpg,920,991,146,200,N,P,test,71,54,3834,si,Amarillo
259,N_P_Mostrando_Amarillos_120_double_box1.jpg,1203,1267,102,156,N,P,test,64,54,3456,si,Amarillo
260,N_P_Mostrando_Amarillos_120_double_box2.jpg,1028,1071,99,145,N,P,test,43,46,1978,si,Amarillo
261,N_P_Mostrando_Amarillos_130_double_box1.jpg,1195,1259,32,93,N,P,test,64,61,3904,si,Amarillo
262,N_P_Mostrando_Amarillos_130_double_box2.jpg,1272,1329,28,89,N,P,test,57,61,3477,si,Amarillo
263,N_P_Mostrando_Amarillos_140_single_box.jpg,1269,1312,256,293,N,P,test,43,37,1591,si,Amarillo
264,N_P_Mostrando_Amarillos_150_single_box.jpg,1228,1269,179,218,N,P,test,41,39,1599,si,Amarillo
265,N_P_Mostrando_Amarillos_20_double_box1.jpg,973,1023,266,309,N,P,train,50,43,2150,si,Amarillo
266,N_P_Mostrando_Amarillos_20_double_box2.jpg,1049,1104,262,320,N,P,train,55,58,3190,si,Amarillo
267,N_P_Mostrando_Amarillos_30_double_box1.jpg,951,1022,198,272,N,P,train,71,74,5254,si,Amarillo
268,N_P_Mostrando_Amarillos_30_double_box2.jpg,1053,1113,202,265,N,P,train,60,63,3780,si,Amarillo
269,N_P_Mostrando_Amarillos_40_double_box1.jpg,1091,1145,179,252,N,P,train,54,73,3942,si,Amarillo
270,N_P_Mostrando_Amarillos_40_double_box2.jpg,949,1002,177,240,N,P,train,53,63,3339,si,Amarillo
271,N_P_Mostrando_Amarillos_50_double_box1.jpg,961,1012,269,308,N,P,train,51,39,1989,si,Amarillo
272,N_P_Mostrando_Amarillos_50_double_box2.jpg,1050,1120,278,319,N,P,train,70,41,2870,si,Amarillo
273,N_P_Mostrando_Amarillos_60_single_box.jpg,955,1026,222,285,N,P,train,71,63,4473,si,Amarillo
274,N_P_Mostrando_Amarillos_70_double_box1.jpg,746,807,5,77,N,P,train,61,72,4392,si,Amarillo
275,N_P_Mostrando_Amarillos_70_double_box2.jpg,859,913,1,63,N,P,train,54,62,3348,si,Amarillo
276,N_P_Mostrando_Amarillos_80_single_box.jpg,785,836,242,295,N,P,train,51,53,2703,si,Amarillo
277,N_P_Mostrando_Amarillos_90_double_box1.jpg,833,899,56,137,N,P,train,66,81,5346,si,Amarillo
278,N_P_Mostrando_Amarillos_90_double_box2.jpg,912,982,53,125,N,P,train,70,72,5040,si,Amarillo
279,N_P_Trabajando_Amarillos_0_single_box.jpg,933,1008,218,273,N,P,train,75,55,4125,si,Amarillo
280,N_P_Trabajando_Amarillos_10_double_box1.jpg,1041,1102,239,282,N,P,train,61,43,2623,si,Amarillo
281,N_P_Trabajando_Amarillos_10_double_box2.jpg,1089,1145,198,258,N,P,train,56,60,3360,si,Amarillo
282,N_P_Trabajando_Amarillos_100_double_box1.jpg,989,1031,245,288,N,P,train,42,43,1806,si,Amarillo
283,N_P_Trabajando_Amarillos_100_double_box2.jpg,1042,1095,243,298,N,P,train,53,55,2915,si,Amarillo
284,N_P_Trabajando_Amarillos_110_double_box1.jpg,1016,1072,249,280,N,P,train,56,31,1736,si,Amarillo
285,N_P_Trabajando_Amarillos_110_double_box2.jpg,1067,1103,261,299,N,P,train,36,38,1368,si,Amarillo
286,N_P_Trabajando_Amarillos_121_single_box.jpg,1075,1123,249,296,N,P,train,48,47,2256,si,Amarillo
287,N_P_Trabajando_Amarillos_132_double_box1.jpg,1030,1104,250,307,N,P,train,74,57,4218,si,Amarillo
288,N_P_Trabajando_Amarillos_132_double_box2.jpg,848,912,236,300,N,P,train,64,64,4096,si,Amarillo
289,N_P_Trabajando_Amarillos_143_double_box1.jpg,940,985,243,290,N,P,train,45,47,2115,si,Amarillo
290,N_P_Trabajando_Amarillos_143_double_box2.jpg,1022,1089,252,299,N,P,train,67,47,3149,si,Amarillo
291,N_P_Trabajando_Amarillos_155_single_box.jpg,1026,1092,256,299,N,P,train,66,43,2838,si,Amarillo
292,N_P_Trabajando_Amarillos_166_single_box.jpg,985,1026,222,269,N,P,train,41,47,1927,si,Amarillo
293,N_P_Trabajando_Amarillos_171_double_box1.jpg,937,995,241,300,N,P,test,58,59,3422,si,Amarillo
294,N_P_Trabajando_Amarillos_171_double_box2.jpg,1028,1086,235,282,N,P,test,58,47,2726,si,Amarillo
295,N_P_Trabajando_Amarillos_193_single_box.jpg,1019,1078,212,272,N,P,test,59,60,3540,si,Amarillo
296,N_P_Trabajando_Amarillos_20_double_box1.jpg,1051,1113,206,253,N,P,train,62,47,2914,si,Amarillo
297,N_P_Trabajando_Amarillos_20_double_box2.jpg,1001,1053,220,272,N,P,train,52,52,2704,si,Amarillo
298,N_P_Trabajando_Amarillos_204_double_box1.jpg,960,1025,231,279,N,P,test,65,48,3120,si,Amarillo
299,N_P_Trabajando_Amarillos_204_double_box2.jpg,1062,1139,230,293,N,P,test,77,63,4851,si,Amarillo
300,N_P_Trabajando_Amarillos_215_single_box.jpg,933,985,212,268,N,P,test,52,56,2912,si,Amarillo
301,N_P_Trabajando_Amarillos_226_double_box1.jpg,1045,1101,252,298,N,P,test,56,46,2576,si,Amarillo
302,N_P_Trabajando_Amarillos_226_double_box2.jpg,963,1026,205,268,N,P,test,63,63,3969,si,Amarillo
303,N_P_Trabajando_Amarillos_237_double_box1.jpg,992,1045,249,290,N,P,test,53,41,2173,si,Amarillo
304,N_P_Trabajando_Amarillos_237_double_box2.jpg,1039,1096,248,293,N,P,test,57,45,2565,si,Amarillo
305,N_P_Trabajando_Amarillos_242_double_box1.jpg,1051,1120,210,278,N,P,test,69,68,4692,si,Amarillo
306,N_P_Trabajando_Amarillos_242_double_box2.jpg,979,1032,228,275,N,P,test,53,47,2491,si,Amarillo
307,N_P_Trabajando_Amarillos_30_double_box1.jpg,1008,1065,240,283,N,P,train,57,43,2451,si,Amarillo
308,N_P_Trabajando_Amarillos_30_double_box2.jpg,1082,1129,235,282,N,P,train,47,47,2209,si,Amarillo
309,N_P_Trabajando_Amarillos_40_single_box.jpg,1002,1069,259,300,N,P,train,67,41,2747,si,Amarillo
310,N_P_Trabajando_Amarillos_50_single_box.jpg,966,1019,246,289,N,P,train,53,43,2279,si,Amarillo
311,N_P_Trabajando_Amarillos_60_single_box.jpg,991,1042,200,253,N,P,train,51,53,2703,si,Amarillo
312,N_P_Trabajando_Amarillos_70_single_box.jpg,1010,1061,247,288,N,P,train,51,41,2091,si,Amarillo
313,N_P_Trabajando_Amarillos_80_single_box.jpg,1005,1068,248,285,N,P,train,63,37,2331,si,Amarillo
314,N_P_Trabajando_Amarillos_90_single_box.jpg,1148,1208,238,282,N,P,train,60,44,2640,si,Amarillo
315,T_G_Mostrando_Amarillos_0_double_box1.jpg,754,856,293,389,T,G,train,102,96,9792,si,Amarillo
316,T_G_Mostrando_Amarillos_0_double_box2.jpg,843,941,309,397,T,G,train,98,88,8624,si,Amarillo
317,T_G_Mostrando_Amarillos_10_double_box1.jpg,686,811,303,459,T,G,train,125,156,19500,si,Amarillo
318,T_G_Mostrando_Amarillos_10_double_box2.jpg,1094,1234,345,493,T,G,train,140,148,20720,si,Amarillo
319,T_G_Mostrando_Amarillos_100_single_box.jpg,929,1143,416,617,T,G,test,214,201,43014,si,Amarillo
320,T_G_Mostrando_Amarillos_110_double_box1.jpg,891,1165,184,323,T,G,test,274,139,38086,si,Amarillo
321,T_G_Mostrando_Amarillos_110_double_box2.jpg,771,955,160,277,T,G,test,184,117,21528,si,Amarillo
322,T_G_Mostrando_Amarillos_20_double_box1.jpg,1194,1455,467,777,T,G,train,261,310,80910,si,Amarillo
323,T_G_Mostrando_Amarillos_20_double_box2.jpg,456,693,376,653,T,G,train,237,277,65649,si,Amarillo
324,T_G_Mostrando_Amarillos_30_double_box1.jpg,874,1078,589,787,T,G,train,204,198,40392,si,Amarillo
325,T_G_Mostrando_Amarillos_30_double_box2.jpg,668,803,550,753,T,G,train,135,203,27405,si,Amarillo
326,T_G_Mostrando_Amarillos_40_double_box1.jpg,1001,1231,254,427,T,G,train,230,173,39790,si,Amarillo
327,T_G_Mostrando_Amarillos_40_double_box2.jpg,752,949,237,424,T,G,train,197,187,36839,si,Amarillo
328,T_G_Mostrando_Amarillos_50_double_box1.jpg,1383,1630,627,927,T,G,train,247,300,74100,si,Amarillo
329,T_G_Mostrando_Amarillos_50_double_box2.jpg,189,424,588,884,T,G,train,235,296,69560,si,Amarillo
330,T_G_Mostrando_Amarillos_60_double_box1.jpg,387,658,587,873,T,G,train,271,286,77506,si,Amarillo
331,T_G_Mostrando_Amarillos_60_double_box2.jpg,1277,1442,633,944,T,G,train,165,311,51315,si,Amarillo
332,T_G_Mostrando_Amarillos_70_double_box1.jpg,1002,1127,448,659,T,G,train,125,211,26375,si,Amarillo
333,T_G_Mostrando_Amarillos_70_double_box2.jpg,729,875,436,640,T,G,train,146,204,29784,si,Amarillo
334,T_G_Mostrando_Amarillos_80_double_box1.jpg,558,728,414,603,T,G,train,170,189,32130,si,Amarillo
335,T_G_Mostrando_Amarillos_80_double_box2.jpg,1094,1258,493,696,T,G,train,164,203,33292,si,Amarillo
336,T_G_Mostrando_Amarillos_82_double_box1.jpg,512,711,413,687,T,G,test,199,274,54526,si,Amarillo
337,T_G_Mostrando_Amarillos_82_double_box2.jpg,1072,1315,488,783,T,G,test,243,295,71685,si,Amarillo
338,T_G_Mostrando_Amarillos_90_double_box1.jpg,1322,1543,360,608,T,G,test,221,248,54808,si,Amarillo
339,T_G_Mostrando_Amarillos_90_double_box2.jpg,389,604,284,500,T,G,test,215,216,46440,si,Amarillo
340,T_G_Trabajando_Amarillos_0_single_box.jpg,776,919,332,404,T,G,train,143,72,10296,si,Amarillo
341,T_G_Trabajando_Amarillos_10_double_box1.jpg,552,754,202,369,T,G,train,202,167,33734,si,Amarillo
342,T_G_Trabajando_Amarillos_10_double_box2.jpg,716,870,292,386,T,G,train,154,94,14476,si,Amarillo
343,T_G_Trabajando_Amarillos_100_double_box1.jpg,1048,1303,215,380,T,G,train,255,165,42075,si,Amarillo
344,T_G_Trabajando_Amarillos_100_double_box2.jpg,823,1077,141,272,T,G,train,254,131,33274,si,Amarillo
345,T_G_Trabajando_Amarillos_111_double_box1.jpg,989,1246,222,399,T,G,train,257,177,45489,si,Amarillo
346,T_G_Trabajando_Amarillos_111_double_box2.jpg,770,998,155,285,T,G,train,228,130,29640,si,Amarillo
347,T_G_Trabajando_Amarillos_126_double_box1.jpg,1134,1409,253,472,T,G,train,275,219,60225,si,Amarillo
348,T_G_Trabajando_Amarillos_126_double_box2.jpg,890,1080,303,501,T,G,train,190,198,37620,si,Amarillo
349,T_G_Trabajando_Amarillos_137_double_box1.jpg,826,1039,354,538,T,G,train,213,184,39192,si,Amarillo
350,T_G_Trabajando_Amarillos_137_double_box2.jpg,720,845,236,389,T,G,train,125,153,19125,si,Amarillo
351,T_G_Trabajando_Amarillos_148_single_box.jpg,988,1181,298,456,T,G,train,193,158,30494,si,Amarillo
352,T_G_Trabajando_Amarillos_151_double_box1.jpg,464,638,357,673,T,G,test,174,316,54984,si,Amarillo
353,T_G_Trabajando_Amarillos_151_double_box2.jpg,1035,1238,336,502,T,G,test,203,166,33698,si,Amarillo
354,T_G_Trabajando_Amarillos_160_double_box1.jpg,1023,1270,321,539,T,G,test,247,218,53846,si,Amarillo
355,T_G_Trabajando_Amarillos_160_double_box2.jpg,1308,1475,300,448,T,G,test,167,148,24716,si,Amarillo
356,T_G_Trabajando_Amarillos_170_single_box.jpg,1071,1320,245,369,T,G,test,249,124,30876,si,Amarillo
357,T_G_Trabajando_Amarillos_180_double_box1.jpg,988,1233,273,448,T,G,test,245,175,42875,si,Amarillo
358,T_G_Trabajando_Amarillos_180_double_box2.jpg,1481,1638,374,539,T,G,test,157,165,25905,si,Amarillo
359,T_G_Trabajando_Amarillos_190_double_box1.jpg,921,1184,368,590,T,G,test,263,222,58386,si,Amarillo
360,T_G_Trabajando_Amarillos_190_double_box2.jpg,747,892,282,454,T,G,test,145,172,24940,si,Amarillo
361,T_G_Trabajando_Amarillos_20_double_box1.jpg,751,956,301,457,T,G,train,205,156,31980,si,Amarillo
362,T_G_Trabajando_Amarillos_20_double_box2.jpg,559,705,243,413,T,G,train,146,170,24820,si,Amarillo
363,T_G_Trabajando_Amarillos_200_double_box1.jpg,981,1214,263,486,T,G,test,233,223,51959,si,Amarillo
364,T_G_Trabajando_Amarillos_200_double_box2.jpg,544,709,257,488,T,G,test,165,231,38115,si,Amarillo
365,T_G_Trabajando_Amarillos_210_double_box1.jpg,790,912,184,313,T,G,test,122,129,15738,si,Amarillo
366,T_G_Trabajando_Amarillos_210_double_box2.jpg,918,1116,218,355,T,G,test,198,137,27126,si,Amarillo
367,T_G_Trabajando_Amarillos_30_single_box.jpg,1130,1269,309,520,T,G,train,139,211,29329,si,Amarillo
368,T_G_Trabajando_Amarillos_40_double_box1.jpg,1171,1351,493,768,T,G,train,180,275,49500,si,Amarillo
369,T_G_Trabajando_Amarillos_40_double_box2.jpg,783,1031,469,813,T,G,train,248,344,85312,si,Amarillo
370,T_G_Trabajando_Amarillos_50_double_box1.jpg,683,928,126,348,T,G,train,245,222,54390,si,Amarillo
371,T_G_Trabajando_Amarillos_50_double_box2.jpg,911,1142,276,442,T,G,train,231,166,38346,si,Amarillo
372,T_G_Trabajando_Amarillos_60_double_box1.jpg,856,1137,199,399,T,G,train,281,200,56200,si,Amarillo
373,T_G_Trabajando_Amarillos_60_double_box2.jpg,686,828,313,472,T,G,train,142,159,22578,si,Amarillo
374,T_G_Trabajando_Amarillos_70_single_box.jpg,754,907,286,486,T,G,train,153,200,30600,si,Amarillo
375,T_G_Trabajando_Amarillos_80_double_box1.jpg,834,1093,254,454,T,G,train,259,200,51800,si,Amarillo
376,T_G_Trabajando_Amarillos_80_double_box2.jpg,474,646,243,435,T,G,train,172,192,33024,si,Amarillo
377,T_G_Trabajando_Amarillos_90_double_box1.jpg,462,734,366,618,T,G,train,272,252,68544,si,Amarillo
378,T_G_Trabajando_Amarillos_90_double_box2.jpg,1042,1254,186,372,T,G,train,212,186,39432,si,Amarillo
379,T_P_Mostrando_Amarillos_0_double_box1.jpg,1260,1315,239,287,T,P,train,55,48,2640,si,Amarillo
380,T_P_Mostrando_Amarillos_0_double_box2.jpg,1176,1229,238,290,T,P,train,53,52,2756,si,Amarillo
381,T_P_Mostrando_Amarillos_10_double_box1.jpg,1162,1207,231,272,T,P,train,45,41,1845,si,Amarillo
382,T_P_Mostrando_Amarillos_10_double_box2.jpg,1207,1269,215,271,T,P,train,62,56,3472,si,Amarillo
383,T_P_Mostrando_Amarillos_100_double_box1.jpg,949,992,184,248,T,P,test,43,64,2752,si,Amarillo
384,T_P_Mostrando_Amarillos_100_double_box2.jpg,1032,1078,179,244,T,P,test,46,65,2990,si,Amarillo
385,T_P_Mostrando_Amarillos_20_double_box1.jpg,1238,1289,258,296,T,P,train,51,38,1938,si,Amarillo
386,T_P_Mostrando_Amarillos_20_double_box2.jpg,1188,1237,256,294,T,P,train,49,38,1862,si,Amarillo
387,T_P_Mostrando_Amarillos_30_double_box1.jpg,1338,1413,272,316,T,P,train,75,44,3300,si,Amarillo
388,T_P_Mostrando_Amarillos_30_double_box2.jpg,1068,1132,263,303,T,P,train,64,40,2560,si,Amarillo
389,T_P_Mostrando_Amarillos_40_double_box1.jpg,1340,1400,249,295,T,P,train,60,46,2760,si,Amarillo
390,T_P_Mostrando_Amarillos_40_double_box2.jpg,1064,1116,235,281,T,P,train,52,46,2392,si,Amarillo
391,T_P_Mostrando_Amarillos_50_double_box1.jpg,1274,1346,101,201,T,P,train,72,100,7200,si,Amarillo
392,T_P_Mostrando_Amarillos_50_double_box2.jpg,1146,1213,75,156,T,P,train,67,81,5427,si,Amarillo
393,T_P_Mostrando_Amarillos_60_double_box1.jpg,1161,1249,41,126,T,P,train,88,85,7480,si,Amarillo
394,T_P_Mostrando_Amarillos_60_double_box2.jpg,1373,1425,93,168,T,P,train,52,75,3900,si,Amarillo
395,T_P_Mostrando_Amarillos_70_double_box1.jpg,1395,1470,211,271,T,P,train,75,60,4500,si,Amarillo
396,T_P_Mostrando_Amarillos_70_double_box2.jpg,1631,1706,207,270,T,P,train,75,63,4725,si,Amarillo
397,T_P_Mostrando_Amarillos_72_double_box1.jpg,1322,1401,62,122,T,P,test,79,60,4740,si,Amarillo
398,T_P_Mostrando_Amarillos_72_double_box2.jpg,1664,1738,101,155,T,P,test,74,54,3996,si,Amarillo
399,T_P_Mostrando_Amarillos_80_double_box1.jpg,998,1064,41,99,T,P,test,66,58,3828,si,Amarillo
400,T_P_Mostrando_Amarillos_80_double_box2.jpg,1062,1132,43,103,T,P,test,70,60,4200,si,Amarillo
401,T_P_Mostrando_Amarillos_90_double_box1.jpg,918,974,203,253,T,P,test,56,50,2800,si,Amarillo
402,T_P_Mostrando_Amarillos_90_double_box2.jpg,1019,1079,199,255,T,P,test,60,56,3360,si,Amarillo
403,T_P_Trabajando_Amarillos_0_double_box1.jpg,1219,1284,243,294,T,P,train,65,51,3315,si,Amarillo
404,T_P_Trabajando_Amarillos_0_double_box2.jpg,1162,1212,238,294,T,P,train,50,56,2800,si,Amarillo
405,T_P_Trabajando_Amarillos_10_double_box1.jpg,1248,1312,246,318,T,P,train,64,72,4608,si,Amarillo
406,T_P_Trabajando_Amarillos_10_double_box2.jpg,1128,1194,231,312,T,P,train,66,81,5346,si,Amarillo
407,T_P_Trabajando_Amarillos_101_double_box1.jpg,1279,1341,237,314,T,P,test,62,77,4774,si,Amarillo
408,T_P_Trabajando_Amarillos_101_double_box2.jpg,1173,1224,231,307,T,P,test,51,76,3876,si,Amarillo
409,T_P_Trabajando_Amarillos_11_double_box1.jpg,1235,1298,251,318,T,P,train,63,67,4221,si,Amarillo
410,T_P_Trabajando_Amarillos_11_double_box2.jpg,1131,1198,248,317,T,P,train,67,69,4623,si,Amarillo
411,T_P_Trabajando_Amarillos_120_single_box.jpg,1188,1234,234,274,T,P,test,46,40,1840,si,Amarillo
412,T_P_Trabajando_Amarillos_23_double_box1.jpg,1225,1304,221,284,T,P,train,79,63,4977,si,Amarillo
413,T_P_Trabajando_Amarillos_23_double_box2.jpg,1327,1379,233,280,T,P,train,52,47,2444,si,Amarillo
414,T_P_Trabajando_Amarillos_35_double_box1.jpg,1258,1311,232,288,T,P,train,53,56,2968,si,Amarillo
415,T_P_Trabajando_Amarillos_35_double_box2.jpg,1203,1258,248,291,T,P,train,55,43,2365,si,Amarillo
416,T_P_Trabajando_Amarillos_46_double_box1.jpg,1251,1285,206,253,T,P,train,34,47,1598,si,Amarillo
417,T_P_Trabajando_Amarillos_46_double_box2.jpg,1215,1252,252,287,T,P,train,37,35,1295,si,Amarillo
418,T_P_Trabajando_Amarillos_57_double_box1.jpg,1265,1314,246,293,T,P,train,49,47,2303,si,Amarillo
419,T_P_Trabajando_Amarillos_57_double_box2.jpg,1194,1247,252,289,T,P,train,53,37,1961,si,Amarillo
420,T_P_Trabajando_Amarillos_68_single_box.jpg,1244,1298,257,298,T,P,train,54,41,2214,si,Amarillo
421,T_P_Trabajando_Amarillos_79_double_box1.jpg,1281,1337,233,285,T,P,train,56,52,2912,si,Amarillo
422,T_P_Trabajando_Amarillos_79_double_box2.jpg,1164,1206,249,314,T,P,train,42,65,2730,si,Amarillo
423,T_P_Trabajando_Amarillos_84_single_box.jpg,1209,1284,241,294,T,P,train,75,53,3975,si,Amarillo
424,T_P_Trabajando_Amarillos_85_double_box1.jpg,1258,1307,253,297,T,P,test,49,44,2156,si,Amarillo
425,T_P_Trabajando_Amarillos_85_double_box2.jpg,1197,1253,243,296,T,P,test,56,53,2968,si,Amarillo
426,T_P_Trabajando_Amarillos_92_double_box1.jpg,1238,1301,233,288,T,P,test,63,55,3465,si,Amarillo
427,T_P_Trabajando_Amarillos_92_double_box2.jpg,1317,1385,218,270,T,P,test,68,52,3536,si,Amarillo
