,filename,xmin,xmax,ymin,ymax,Time,Size,Type,Hand_Pixel_Width,Hand_Pixel_Height,Area,guantes,color
0,M_G_Mostrando_Verdes_101_double_box1.jpg,816,1054,225,365,M,G,train,238,140,33320,si,Verde
1,M_G_Mostrando_Verdes_101_double_box2.jpg,443,625,154,297,M,G,train,182,143,26026,si,Verde
2,M_G_Mostrando_Verdes_112_double_box1.jpg,662,883,268,463,M,G,train,221,195,43095,si,Verde
3,M_G_Mostrando_Verdes_112_double_box2.jpg,1006,1211,288,490,M,G,train,205,202,41410,si,Verde
4,M_G_Mostrando_Verdes_123_double_box1.jpg,968,1225,193,440,M,G,train,257,247,63479,si,Verde
5,M_G_Mostrando_Verdes_123_double_box2.jpg,239,478,97,335,M,G,train,239,238,56882,si,Verde
6,M_G_Mostrando_Verdes_134_double_box1.jpg,1346,1524,280,413,M,G,train,178,133,23674,si,Verde
7,M_G_Mostrando_Verdes_134_double_box2.jpg,665,943,202,362,M,G,train,278,160,44480,si,Verde
8,M_G_Mostrando_Verdes_145_double_box1.jpg,1286,1543,143,317,M,G,train,257,174,44718,si,Verde
9,M_G_Mostrando_Verdes_145_double_box2.jpg,322,541,81,263,M,G,train,219,182,39858,si,Verde
10,M_G_Mostrando_Verdes_157_double_box1.jpg,571,768,178,327,M,G,train,197,149,29353,si,Verde
11,M_G_Mostrando_Verdes_157_double_box2.jpg,907,1081,202,328,M,G,train,174,126,21924,si,Verde
12,M_G_Mostrando_Verdes_168_double_box1.jpg,559,713,156,303,M,G,train,154,147,22638,si,Verde
13,M_G_Mostrando_Verdes_168_double_box2.jpg,856,1036,193,348,M,G,train,180,155,27900,si,Verde
14,M_G_Mostrando_Verdes_171_double_box1.jpg,509,646,122,268,M,G,test,137,146,20002,si,Verde
15,M_G_Mostrando_Verdes_171_double_box2.jpg,922,1090,166,325,M,G,test,168,159,26712,si,Verde
16,M_G_Mostrando_Verdes_18_double_box1.jpg,814,1043,143,278,M,G,train,229,135,30915,si,Verde
17,M_G_Mostrando_Verdes_18_double_box2.jpg,674,824,163,278,M,G,train,150,115,17250,si,Verde
18,M_G_Mostrando_Verdes_182_double_box1.jpg,1137,1337,257,392,M,G,test,200,135,27000,si,Verde
19,M_G_Mostrando_Verdes_182_double_box2.jpg,344,532,212,333,M,G,test,188,121,22748,si,Verde
20,M_G_Mostrando_Verdes_193_double_box1.jpg,1014,1258,295,514,M,G,test,244,219,53436,si,Verde
21,M_G_Mostrando_Verdes_193_double_box2.jpg,375,582,245,445,M,G,test,207,200,41400,si,Verde
22,M_G_Mostrando_Verdes_204_double_box1.jpg,769,1027,523,765,M,G,test,258,242,62436,si,Verde
23,M_G_Mostrando_Verdes_204_double_box2.jpg,430,630,479,718,M,G,test,200,239,47800,si,Verde
24,M_G_Mostrando_Verdes_216_double_box1.jpg,1109,1330,167,313,M,G,test,221,146,32266,si,Verde
25,M_G_Mostrando_Verdes_216_double_box2.jpg,92,312,29,211,M,G,test,220,182,40040,si,Verde
26,M_G_Mostrando_Verdes_225_double_box1.jpg,1088,1313,318,527,M,G,test,225,209,47025,si,Verde
27,M_G_Mostrando_Verdes_225_double_box2.jpg,274,482,265,479,M,G,test,208,214,44512,si,Verde
28,M_G_Mostrando_Verdes_234_double_box1.jpg,580,734,270,378,M,G,test,154,108,16632,si,Verde
29,M_G_Mostrando_Verdes_234_double_box2.jpg,806,1017,274,401,M,G,test,211,127,26797,si,Verde
30,M_G_Mostrando_Verdes_242_double_box1.jpg,205,465,448,705,M,G,test,260,257,66820,si,Verde
31,M_G_Mostrando_Verdes_242_double_box2.jpg,768,1022,311,440,M,G,test,254,129,32766,si,Verde
32,M_G_Mostrando_Verdes_27_double_box1.jpg,753,914,191,282,M,G,train,161,91,14651,si,Verde
33,M_G_Mostrando_Verdes_27_double_box2.jpg,879,1020,182,341,M,G,train,141,159,22419,si,Verde
34,M_G_Mostrando_Verdes_36_double_box1.jpg,219,477,445,714,M,G,train,258,269,69402,si,Verde
35,M_G_Mostrando_Verdes_36_double_box2.jpg,887,1110,326,500,M,G,train,223,174,38802,si,Verde
36,M_G_Mostrando_Verdes_45_double_box1.jpg,291,523,487,835,M,G,train,232,348,80736,si,Verde
37,M_G_Mostrando_Verdes_45_double_box2.jpg,443,804,553,890,M,G,train,361,337,121657,si,Verde
38,M_G_Mostrando_Verdes_54_double_box1.jpg,603,806,267,474,M,G,train,203,207,42021,si,Verde
39,M_G_Mostrando_Verdes_54_double_box2.jpg,974,1193,287,491,M,G,train,219,204,44676,si,Verde
40,M_G_Mostrando_Verdes_63_double_box1.jpg,680,969,480,776,M,G,train,289,296,85544,si,Verde
41,M_G_Mostrando_Verdes_63_double_box2.jpg,1202,1435,437,721,M,G,train,233,284,66172,si,Verde
42,M_G_Mostrando_Verdes_72_double_box1.jpg,1090,1302,508,741,M,G,train,212,233,49396,si,Verde
43,M_G_Mostrando_Verdes_72_double_box2.jpg,443,634,484,733,M,G,train,191,249,47559,si,Verde
44,M_G_Mostrando_Verdes_81_double_box1.jpg,503,773,476,687,M,G,train,270,211,56970,si,Verde
45,M_G_Mostrando_Verdes_81_double_box2.jpg,318,496,341,524,M,G,train,178,183,32574,si,Verde
46,M_G_Mostrando_Verdes_9_single_box.jpg,627,827,256,476,M,G,train,200,220,44000,si,Verde
47,M_G_Mostrando_Verdes_90_double_box1.jpg,179,363,136,264,M,G,train,184,128,23552,si,Verde
48,M_G_Mostrando_Verdes_90_double_box2.jpg,1192,1387,271,457,M,G,train,195,186,36270,si,Verde
49,M_G_Trabajando_Verdes_0_double_box1.jpg,210,466,432,717,M,G,train,256,285,72960,si,Verde
50,M_G_Trabajando_Verdes_0_double_box2.jpg,905,1159,337,465,M,G,train,254,128,32512,si,Verde
51,M_G_Trabajando_Verdes_109_double_box1.jpg,943,1168,384,632,M,G,train,225,248,55800,si,Verde
52,M_G_Trabajando_Verdes_109_double_box2.jpg,640,772,294,373,M,G,train,132,79,10428,si,Verde
53,M_G_Trabajando_Verdes_12_double_box1.jpg,395,563,320,610,M,G,train,168,290,48720,si,Verde
54,M_G_Trabajando_Verdes_12_double_box2.jpg,529,831,419,778,M,G,train,302,359,108418,si,Verde
55,M_G_Trabajando_Verdes_120_double_box1.jpg,629,793,289,379,M,G,train,164,90,14760,si,Verde
56,M_G_Trabajando_Verdes_120_double_box2.jpg,1544,1692,261,448,M,G,train,148,187,27676,si,Verde
57,M_G_Trabajando_Verdes_132_double_box1.jpg,1359,1555,404,687,M,G,train,196,283,55468,si,Verde
58,M_G_Trabajando_Verdes_132_double_box2.jpg,1566,1718,324,563,M,G,train,152,239,36328,si,Verde
59,M_G_Trabajando_Verdes_145_double_box1.jpg,556,718,195,285,M,G,train,162,90,14580,si,Verde
60,M_G_Trabajando_Verdes_145_double_box2.jpg,615,894,251,436,M,G,train,279,185,51615,si,Verde
61,M_G_Trabajando_Verdes_156_single_box.jpg,1499,1690,299,509,M,G,train,191,210,40110,si,Verde
62,M_G_Trabajando_Verdes_169_single_box.jpg,996,1320,308,572,M,G,train,324,264,85536,si,Verde
63,M_G_Trabajando_Verdes_178_single_box.jpg,913,1168,213,389,M,G,train,255,176,44880,si,Verde
64,M_G_Trabajando_Verdes_189_double_box1.jpg,729,940,218,382,M,G,train,211,164,34604,si,Verde
65,M_G_Trabajando_Verdes_189_double_box2.jpg,1123,1237,233,349,M,G,train,114,116,13224,si,Verde
66,M_G_Trabajando_Verdes_198_double_box1.jpg,919,1128,144,358,M,G,train,209,214,44726,si,Verde
67,M_G_Trabajando_Verdes_198_double_box2.jpg,616,811,252,431,M,G,train,195,179,34905,si,Verde
68,M_G_Trabajando_Verdes_210_double_box1.jpg,546,696,189,348,M,G,train,150,159,23850,si,Verde
69,M_G_Trabajando_Verdes_210_double_box2.jpg,1149,1273,215,352,M,G,train,124,137,16988,si,Verde
70,M_G_Trabajando_Verdes_221_single_box.jpg,853,1109,269,432,M,G,train,256,163,41728,si,Verde
71,M_G_Trabajando_Verdes_224_single_box.jpg,839,1080,339,502,M,G,test,241,163,39283,si,Verde
72,M_G_Trabajando_Verdes_236_double_box1.jpg,845,959,279,472,M,G,test,114,193,22002,si,Verde
73,M_G_Trabajando_Verdes_236_double_box2.jpg,953,1085,315,472,M,G,test,132,157,20724,si,Verde
74,M_G_Trabajando_Verdes_24_double_box1.jpg,748,931,112,250,M,G,train,183,138,25254,si,Verde
75,M_G_Trabajando_Verdes_24_double_box2.jpg,890,1051,274,395,M,G,train,161,121,19481,si,Verde
76,M_G_Trabajando_Verdes_248_single_box.jpg,962,1266,162,402,M,G,test,304,240,72960,si,Verde
77,M_G_Trabajando_Verdes_258_double_box1.jpg,1083,1287,176,323,M,G,test,204,147,29988,si,Verde
78,M_G_Trabajando_Verdes_258_double_box2.jpg,832,1111,204,350,M,G,test,279,146,40734,si,Verde
79,M_G_Trabajando_Verdes_269_double_box1.jpg,865,1116,184,351,M,G,test,251,167,41917,si,Verde
80,M_G_Trabajando_Verdes_269_double_box2.jpg,1146,1283,200,365,M,G,test,137,165,22605,si,Verde
81,M_G_Trabajando_Verdes_278_double_box1.jpg,880,1108,233,400,M,G,test,228,167,38076,si,Verde
82,M_G_Trabajando_Verdes_278_double_box2.jpg,1134,1275,109,260,M,G,test,141,151,21291,si,Verde
83,M_G_Trabajando_Verdes_289_single_box.jpg,663,868,117,280,M,G,test,205,163,33415,si,Verde
84,M_G_Trabajando_Verdes_298_single_box.jpg,598,809,176,316,M,G,test,211,140,29540,si,Verde
85,M_G_Trabajando_Verdes_300_double_box1.jpg,714,912,191,300,M,G,test,198,109,21582,si,Verde
86,M_G_Trabajando_Verdes_300_double_box2.jpg,683,844,150,222,M,G,test,161,72,11592,si,Verde
87,M_G_Trabajando_Verdes_310_double_box1.jpg,732,901,156,281,M,G,test,169,125,21125,si,Verde
88,M_G_Trabajando_Verdes_310_double_box2.jpg,885,1066,176,276,M,G,test,181,100,18100,si,Verde
89,M_G_Trabajando_Verdes_36_double_box1.jpg,724,973,73,318,M,G,train,249,245,61005,si,Verde
90,M_G_Trabajando_Verdes_36_double_box2.jpg,961,1143,229,362,M,G,train,182,133,24206,si,Verde
91,M_G_Trabajando_Verdes_44_double_box1.jpg,710,931,165,280,M,G,train,221,115,25415,si,Verde
92,M_G_Trabajando_Verdes_44_double_box2.jpg,1179,1320,232,447,M,G,train,141,215,30315,si,Verde
93,M_G_Trabajando_Verdes_53_double_box1.jpg,1192,1320,113,326,M,G,train,128,213,27264,si,Verde
94,M_G_Trabajando_Verdes_53_double_box2.jpg,842,1099,186,297,M,G,train,257,111,28527,si,Verde
95,M_G_Trabajando_Verdes_62_double_box1.jpg,847,1059,83,271,M,G,train,212,188,39856,si,Verde
96,M_G_Trabajando_Verdes_62_double_box2.jpg,744,839,174,319,M,G,train,95,145,13775,si,Verde
97,M_G_Trabajando_Verdes_78_single_box.jpg,614,748,289,441,M,G,train,134,152,20368,si,Verde
98,M_G_Trabajando_Verdes_89_single_box.jpg,412,627,267,435,M,G,train,215,168,36120,si,Verde
99,M_G_Trabajando_Verdes_98_single_box.jpg,420,670,337,474,M,G,train,250,137,34250,si,Verde
100,M_P_Mostrando_Verdes_0_single_box.jpg,813,883,117,178,M,P,train,70,61,4270,si,Verde
101,M_P_Mostrando_Verdes_11_single_box.jpg,1035,1098,104,149,M,P,train,63,45,2835,si,Verde
102,M_P_Mostrando_Verdes_110_double_box1.jpg,1277,1336,232,308,M,P,train,59,76,4484,si,Verde
103,M_P_Mostrando_Verdes_110_double_box2.jpg,1270,1347,99,172,M,P,train,77,73,5621,si,Verde
104,M_P_Mostrando_Verdes_121_double_box1.jpg,948,1020,157,203,M,P,train,72,46,3312,si,Verde
105,M_P_Mostrando_Verdes_121_double_box2.jpg,1152,1212,197,254,M,P,train,60,57,3420,si,Verde
106,M_P_Mostrando_Verdes_133_double_box1.jpg,680,772,86,144,M,P,train,92,58,5336,si,Verde
107,M_P_Mostrando_Verdes_133_double_box2.jpg,830,901,168,235,M,P,train,71,67,4757,si,Verde
108,M_P_Mostrando_Verdes_145_double_box1.jpg,693,772,272,332,M,P,train,79,60,4740,si,Verde
109,M_P_Mostrando_Verdes_145_double_box2.jpg,831,898,273,320,M,P,train,67,47,3149,si,Verde
110,M_P_Mostrando_Verdes_154_double_box1.jpg,841,902,258,314,M,P,train,61,56,3416,si,Verde
111,M_P_Mostrando_Verdes_154_double_box2.jpg,704,785,271,325,M,P,train,81,54,4374,si,Verde
112,M_P_Mostrando_Verdes_163_single_box.jpg,879,926,276,326,M,P,train,47,50,2350,si,Verde
113,M_P_Mostrando_Verdes_172_double_box1.jpg,660,727,83,156,M,P,train,67,73,4891,si,Verde
114,M_P_Mostrando_Verdes_172_double_box2.jpg,964,1027,122,210,M,P,train,63,88,5544,si,Verde
115,M_P_Mostrando_Verdes_182_double_box1.jpg,793,858,294,350,M,P,train,65,56,3640,si,Verde
116,M_P_Mostrando_Verdes_182_double_box2.jpg,856,921,288,338,M,P,train,65,50,3250,si,Verde
117,M_P_Mostrando_Verdes_184_double_box1.jpg,708,796,292,338,M,P,test,88,46,4048,si,Verde
118,M_P_Mostrando_Verdes_184_double_box2.jpg,939,1006,290,333,M,P,test,67,43,2881,si,Verde
119,M_P_Mostrando_Verdes_195_double_box1.jpg,789,846,265,313,M,P,test,57,48,2736,si,Verde
120,M_P_Mostrando_Verdes_195_double_box2.jpg,854,916,267,311,M,P,test,62,44,2728,si,Verde
121,M_P_Mostrando_Verdes_206_double_box1.jpg,706,748,159,212,M,P,test,42,53,2226,si,Verde
122,M_P_Mostrando_Verdes_206_double_box2.jpg,919,985,165,224,M,P,test,66,59,3894,si,Verde
123,M_P_Mostrando_Verdes_217_double_box1.jpg,702,777,182,243,M,P,test,75,61,4575,si,Verde
124,M_P_Mostrando_Verdes_217_double_box2.jpg,891,943,202,245,M,P,test,52,43,2236,si,Verde
125,M_P_Mostrando_Verdes_22_double_box1.jpg,766,839,165,217,M,P,train,73,52,3796,si,Verde
126,M_P_Mostrando_Verdes_22_double_box2.jpg,1121,1195,176,255,M,P,train,74,79,5846,si,Verde
127,M_P_Mostrando_Verdes_226_double_box1.jpg,681,756,128,185,M,P,test,75,57,4275,si,Verde
128,M_P_Mostrando_Verdes_226_double_box2.jpg,1049,1108,174,226,M,P,test,59,52,3068,si,Verde
129,M_P_Mostrando_Verdes_235_double_box1.jpg,837,906,263,315,M,P,test,69,52,3588,si,Verde
130,M_P_Mostrando_Verdes_235_double_box2.jpg,748,816,269,319,M,P,test,68,50,3400,si,Verde
131,M_P_Mostrando_Verdes_244_single_box.jpg,782,843,178,232,M,P,test,61,54,3294,si,Verde
132,M_P_Mostrando_Verdes_253_single_box.jpg,721,798,176,246,M,P,test,77,70,5390,si,Verde
133,M_P_Mostrando_Verdes_34_double_box1.jpg,764,840,236,323,M,P,train,76,87,6612,si,Verde
134,M_P_Mostrando_Verdes_34_double_box2.jpg,894,962,230,296,M,P,train,68,66,4488,si,Verde
135,M_P_Mostrando_Verdes_45_double_box1.jpg,687,772,288,343,M,P,train,85,55,4675,si,Verde
136,M_P_Mostrando_Verdes_45_double_box2.jpg,836,908,289,340,M,P,train,72,51,3672,si,Verde
137,M_P_Mostrando_Verdes_56_double_box1.jpg,973,1031,251,310,M,P,train,58,59,3422,si,Verde
138,M_P_Mostrando_Verdes_56_double_box2.jpg,855,903,247,304,M,P,train,48,57,2736,si,Verde
139,M_P_Mostrando_Verdes_67_double_box1.jpg,991,1058,129,189,M,P,train,67,60,4020,si,Verde
140,M_P_Mostrando_Verdes_67_double_box2.jpg,829,877,112,177,M,P,train,48,65,3120,si,Verde
141,M_P_Mostrando_Verdes_78_double_box1.jpg,776,851,101,168,M,P,train,75,67,5025,si,Verde
142,M_P_Mostrando_Verdes_78_double_box2.jpg,983,1046,109,174,M,P,train,63,65,4095,si,Verde
143,M_P_Mostrando_Verdes_89_single_box.jpg,653,720,61,130,M,P,train,67,69,4623,si,Verde
144,M_P_Mostrando_Verdes_99_double_box1.jpg,1236,1327,116,183,M,P,train,91,67,6097,si,Verde
145,M_P_Mostrando_Verdes_99_double_box2.jpg,971,1050,110,164,M,P,train,79,54,4266,si,Verde
146,M_P_Trabajando_Verdes_109_double_box1.jpg,780,847,228,269,M,P,train,67,41,2747,si,Verde
147,M_P_Trabajando_Verdes_109_double_box2.jpg,714,779,265,311,M,P,train,65,46,2990,si,Verde
148,M_P_Trabajando_Verdes_120_single_box.jpg,876,919,242,274,M,P,train,43,32,1376,si,Verde
149,M_P_Trabajando_Verdes_131_double_box1.jpg,960,1028,213,254,M,P,train,68,41,2788,si,Verde
150,M_P_Trabajando_Verdes_131_double_box2.jpg,1010,1077,259,297,M,P,train,67,38,2546,si,Verde
151,M_P_Trabajando_Verdes_137_double_box1.jpg,894,967,237,268,M,P,test,73,31,2263,si,Verde
152,M_P_Trabajando_Verdes_137_double_box2.jpg,968,1014,241,290,M,P,test,46,49,2254,si,Verde
153,M_P_Trabajando_Verdes_148_single_box.jpg,873,942,228,262,M,P,test,69,34,2346,si,Verde
154,M_P_Trabajando_Verdes_156_single_box.jpg,895,947,240,281,M,P,test,52,41,2132,si,Verde
155,M_P_Trabajando_Verdes_165_double_box1.jpg,874,943,244,275,M,P,test,69,31,2139,si,Verde
156,M_P_Trabajando_Verdes_165_double_box2.jpg,944,969,268,304,M,P,test,25,36,900,si,Verde
157,M_P_Trabajando_Verdes_174_double_box1.jpg,931,989,239,276,M,P,test,58,37,2146,si,Verde
158,M_P_Trabajando_Verdes_174_double_box2.jpg,876,931,252,293,M,P,test,55,41,2255,si,Verde
159,M_P_Trabajando_Verdes_183_double_box1.jpg,930,983,248,273,M,P,test,53,25,1325,si,Verde
160,M_P_Trabajando_Verdes_183_double_box2.jpg,877,928,254,302,M,P,test,51,48,2448,si,Verde
161,M_P_Trabajando_Verdes_192_single_box.jpg,870,931,247,290,M,P,test,61,43,2623,si,Verde
162,M_P_Trabajando_Verdes_20_double_box1.jpg,918,983,263,306,M,P,train,65,43,2795,si,Verde
163,M_P_Trabajando_Verdes_20_double_box2.jpg,988,1045,264,315,M,P,train,57,51,2907,si,Verde
164,M_P_Trabajando_Verdes_31_double_box1.jpg,925,963,167,193,M,P,train,38,26,988,si,Verde
165,M_P_Trabajando_Verdes_31_double_box2.jpg,880,917,215,257,M,P,train,37,42,1554,si,Verde
166,M_P_Trabajando_Verdes_42_double_box1.jpg,788,842,284,323,M,P,train,54,39,2106,si,Verde
167,M_P_Trabajando_Verdes_42_double_box2.jpg,845,890,265,304,M,P,train,45,39,1755,si,Verde
168,M_P_Trabajando_Verdes_55_single_box.jpg,847,913,238,281,M,P,train,66,43,2838,si,Verde
169,M_P_Trabajando_Verdes_65_single_box.jpg,808,863,242,279,M,P,train,55,37,2035,si,Verde
170,M_P_Trabajando_Verdes_76_double_box1.jpg,944,994,246,289,M,P,train,50,43,2150,si,Verde
171,M_P_Trabajando_Verdes_76_double_box2.jpg,858,907,241,290,M,P,train,49,49,2401,si,Verde
172,M_P_Trabajando_Verdes_87_single_box.jpg,890,970,225,282,M,P,train,80,57,4560,si,Verde
173,M_P_Trabajando_Verdes_9_double_box1.jpg,906,967,240,276,M,P,train,61,36,2196,si,Verde
174,M_P_Trabajando_Verdes_9_double_box2.jpg,844,875,251,294,M,P,train,31,43,1333,si,Verde
175,M_P_Trabajando_Verdes_98_double_box1.jpg,876,927,174,235,M,P,train,51,61,3111,si,Verde
176,M_P_Trabajando_Verdes_98_double_box2.jpg,865,908,251,296,M,P,train,43,45,1935,si,Verde
177,N_G_Mostrando_Verdes_17_double_box1.jpg,953,1136,352,508,N,G,train,183,156,28548,si,Verde
178,N_G_Mostrando_Verdes_17_double_box2.jpg,681,847,347,502,N,G,train,166,155,25730,si,Verde
179,N_G_Mostrando_Verdes_28_double_box1.jpg,1410,1555,471,692,N,G,train,145,221,32045,si,Verde
180,N_G_Mostrando_Verdes_28_double_box2.jpg,322,472,429,624,N,G,train,150,195,29250,si,Verde
181,N_G_Mostrando_Verdes_39_single_box.jpg,912,1155,482,794,N,G,train,243,312,75816,si,Verde
182,N_G_Mostrando_Verdes_48_double_box1.jpg,1215,1437,368,631,N,G,train,222,263,58386,si,Verde
183,N_G_Mostrando_Verdes_48_double_box2.jpg,424,648,384,646,N,G,train,224,262,58688,si,Verde
184,N_G_Mostrando_Verdes_53_single_box.jpg,1017,1262,419,723,N,G,train,245,304,74480,si,Verde
185,N_G_Mostrando_Verdes_54_double_box1.jpg,1010,1218,396,595,N,G,test,208,199,41392,si,Verde
186,N_G_Mostrando_Verdes_54_double_box2.jpg,614,794,376,572,N,G,test,180,196,35280,si,Verde
187,N_G_Mostrando_Verdes_6_single_box.jpg,789,1147,68,250,N,G,train,358,182,65156,si,Verde
188,N_G_Mostrando_Verdes_61_double_box1.jpg,1138,1289,352,551,N,G,test,151,199,30049,si,Verde
189,N_G_Mostrando_Verdes_61_double_box2.jpg,525,655,304,514,N,G,test,130,210,27300,si,Verde
190,N_G_Mostrando_Verdes_70_double_box1.jpg,442,711,370,646,N,G,test,269,276,74244,si,Verde
191,N_G_Mostrando_Verdes_70_double_box2.jpg,1159,1380,397,679,N,G,test,221,282,62322,si,Verde
192,N_G_Trabajando_Verdes_102_double_box1.jpg,148,359,644,782,N,G,train,211,138,29118,si,Verde
193,N_G_Trabajando_Verdes_102_double_box2.jpg,274,503,397,584,N,G,train,229,187,42823,si,Verde
194,N_G_Trabajando_Verdes_112_single_box.jpg,864,1079,252,455,N,G,train,215,203,43645,si,Verde
195,N_G_Trabajando_Verdes_121_double_box1.jpg,1425,1600,394,573,N,G,train,175,179,31325,si,Verde
196,N_G_Trabajando_Verdes_121_double_box2.jpg,1391,1630,650,864,N,G,train,239,214,51146,si,Verde
197,N_G_Trabajando_Verdes_134_single_box.jpg,770,1020,263,425,N,G,train,250,162,40500,si,Verde
198,N_G_Trabajando_Verdes_145_double_box1.jpg,500,762,350,485,N,G,test,262,135,35370,si,Verde
199,N_G_Trabajando_Verdes_145_double_box2.jpg,606,747,279,391,N,G,test,141,112,15792,si,Verde
200,N_G_Trabajando_Verdes_15_double_box1.jpg,1342,1548,370,630,N,G,train,206,260,53560,si,Verde
201,N_G_Trabajando_Verdes_15_double_box2.jpg,210,484,355,597,N,G,train,274,242,66308,si,Verde
202,N_G_Trabajando_Verdes_156_double_box1.jpg,700,979,274,447,N,G,test,279,173,48267,si,Verde
203,N_G_Trabajando_Verdes_156_double_box2.jpg,536,695,219,363,N,G,test,159,144,22896,si,Verde
204,N_G_Trabajando_Verdes_167_single_box.jpg,677,825,265,450,N,G,test,148,185,27380,si,Verde
205,N_G_Trabajando_Verdes_178_double_box1.jpg,390,654,437,659,N,G,test,264,222,58608,si,Verde
206,N_G_Trabajando_Verdes_178_double_box2.jpg,223,350,373,549,N,G,test,127,176,22352,si,Verde
207,N_G_Trabajando_Verdes_189_double_box1.jpg,761,939,231,382,N,G,test,178,151,26878,si,Verde
208,N_G_Trabajando_Verdes_189_double_box2.jpg,978,1165,270,373,N,G,test,187,103,19261,si,Verde
209,N_G_Trabajando_Verdes_197_single_box.jpg,741,901,234,390,N,G,test,160,156,24960,si,Verde
210,N_G_Trabajando_Verdes_26_double_box1.jpg,179,400,395,647,N,G,train,221,252,55692,si,Verde
211,N_G_Trabajando_Verdes_26_double_box2.jpg,484,808,457,739,N,G,train,324,282,91368,si,Verde
212,N_G_Trabajando_Verdes_37_double_box1.jpg,679,863,405,655,N,G,train,184,250,46000,si,Verde
213,N_G_Trabajando_Verdes_37_double_box2.jpg,964,1143,385,640,N,G,train,179,255,45645,si,Verde
214,N_G_Trabajando_Verdes_4_single_box.jpg,584,766,252,452,N,G,train,182,200,36400,si,Verde
215,N_G_Trabajando_Verdes_46_double_box1.jpg,658,889,280,522,N,G,train,231,242,55902,si,Verde
216,N_G_Trabajando_Verdes_46_double_box2.jpg,571,680,221,483,N,G,train,109,262,28558,si,Verde
217,N_G_Trabajando_Verdes_55_double_box1.jpg,803,1022,337,487,N,G,train,219,150,32850,si,Verde
218,N_G_Trabajando_Verdes_55_double_box2.jpg,617,801,302,435,N,G,train,184,133,24472,si,Verde
219,N_G_Trabajando_Verdes_67_double_box1.jpg,648,838,194,429,N,G,train,190,235,44650,si,Verde
220,N_G_Trabajando_Verdes_67_double_box2.jpg,1120,1324,327,547,N,G,train,204,220,44880,si,Verde
221,N_G_Trabajando_Verdes_77_single_box.jpg,772,1058,183,383,N,G,train,286,200,57200,si,Verde
222,N_G_Trabajando_Verdes_86_double_box1.jpg,931,1096,324,497,N,G,train,165,173,28545,si,Verde
223,N_G_Trabajando_Verdes_86_double_box2.jpg,598,792,299,531,N,G,train,194,232,45008,si,Verde
224,N_G_Trabajando_Verdes_95_double_box1.jpg,776,974,248,397,N,G,train,198,149,29502,si,Verde
225,N_G_Trabajando_Verdes_95_double_box2.jpg,859,1092,337,489,N,G,train,233,152,35416,si,Verde
226,N_P_Mostrando_Verdes_0_double_box1.jpg,963,1015,254,298,N,P,train,52,44,2288,si,Verde
227,N_P_Mostrando_Verdes_0_double_box2.jpg,1063,1122,252,303,N,P,train,59,51,3009,si,Verde
228,N_P_Mostrando_Verdes_10_double_box1.jpg,975,1036,132,206,N,P,train,61,74,4514,si,Verde
229,N_P_Mostrando_Verdes_10_double_box2.jpg,1058,1132,130,209,N,P,train,74,79,5846,si,Verde
230,N_P_Mostrando_Verdes_100_double_box1.jpg,900,957,20,106,N,P,train,57,86,4902,si,Verde
231,N_P_Mostrando_Verdes_100_double_box2.jpg,1129,1200,15,92,N,P,train,71,77,5467,si,Verde
232,N_P_Mostrando_Verdes_110_single_box.jpg,903,971,225,268,N,P,test,68,43,2924,si,Verde
233,N_P_Mostrando_Verdes_120_double_box1.jpg,1215,1259,43,103,N,P,test,44,60,2640,si,Verde
234,N_P_Mostrando_Verdes_120_double_box2.jpg,998,1053,32,100,N,P,test,55,68,3740,si,Verde
235,N_P_Mostrando_Verdes_130_double_box1.jpg,1154,1215,1,65,N,P,test,61,64,3904,si,Verde
236,N_P_Mostrando_Verdes_130_double_box2.jpg,1298,1362,6,88,N,P,test,64,82,5248,si,Verde
237,N_P_Mostrando_Verdes_140_single_box.jpg,1232,1273,265,315,N,P,test,41,50,2050,si,Verde
238,N_P_Mostrando_Verdes_150_double_box1.jpg,1258,1309,66,123,N,P,test,51,57,2907,si,Verde
239,N_P_Mostrando_Verdes_150_double_box2.jpg,1193,1238,65,128,N,P,test,45,63,2835,si,Verde
240,N_P_Mostrando_Verdes_20_double_box1.jpg,973,1033,279,326,N,P,train,60,47,2820,si,Verde
241,N_P_Mostrando_Verdes_20_double_box2.jpg,1053,1112,282,338,N,P,train,59,56,3304,si,Verde
242,N_P_Mostrando_Verdes_30_double_box1.jpg,1049,1096,212,258,N,P,train,47,46,2162,si,Verde
243,N_P_Mostrando_Verdes_30_double_box2.jpg,996,1051,209,259,N,P,train,55,50,2750,si,Verde
244,N_P_Mostrando_Verdes_40_double_box1.jpg,976,1041,123,180,N,P,train,65,57,3705,si,Verde
245,N_P_Mostrando_Verdes_40_double_box2.jpg,1053,1103,128,172,N,P,train,50,44,2200,si,Verde
246,N_P_Mostrando_Verdes_50_double_box1.jpg,907,982,153,241,N,P,train,75,88,6600,si,Verde
247,N_P_Mostrando_Verdes_50_double_box2.jpg,1108,1165,148,251,N,P,train,57,103,5871,si,Verde
248,N_P_Mostrando_Verdes_60_double_box1.jpg,858,905,214,273,N,P,train,47,59,2773,si,Verde
249,N_P_Mostrando_Verdes_60_double_box2.jpg,983,1043,216,282,N,P,train,60,66,3960,si,Verde
250,N_P_Mostrando_Verdes_70_double_box1.jpg,914,955,1,51,N,P,train,41,50,2050,si,Verde
251,N_P_Mostrando_Verdes_70_double_box2.jpg,804,851,1,63,N,P,train,47,62,2914,si,Verde
252,N_P_Mostrando_Verdes_80_single_box.jpg,799,862,238,306,N,P,train,63,68,4284,si,Verde
253,N_P_Mostrando_Verdes_90_single_box.jpg,835,893,50,111,N,P,train,58,61,3538,si,Verde
254,N_P_Trabajando_Verdes_0_single_box.jpg,972,1033,182,255,N,P,train,61,73,4453,si,Verde
255,N_P_Trabajando_Verdes_10_single_box.jpg,1038,1105,210,260,N,P,train,67,50,3350,si,Verde
256,N_P_Trabajando_Verdes_100_double_box1.jpg,1002,1071,239,293,N,P,train,69,54,3726,si,Verde
257,N_P_Trabajando_Verdes_100_double_box2.jpg,938,985,240,285,N,P,train,47,45,2115,si,Verde
258,N_P_Trabajando_Verdes_110_double_box1.jpg,1087,1153,238,301,N,P,train,66,63,4158,si,Verde
259,N_P_Trabajando_Verdes_110_double_box2.jpg,916,976,235,286,N,P,train,60,51,3060,si,Verde
260,N_P_Trabajando_Verdes_120_single_box.jpg,1006,1068,232,289,N,P,train,62,57,3534,si,Verde
261,N_P_Trabajando_Verdes_129_single_box.jpg,972,1019,238,282,N,P,test,47,44,2068,si,Verde
262,N_P_Trabajando_Verdes_137_single_box.jpg,1081,1152,239,292,N,P,test,71,53,3763,si,Verde
263,N_P_Trabajando_Verdes_146_double_box1.jpg,959,1018,257,292,N,P,test,59,35,2065,si,Verde
264,N_P_Trabajando_Verdes_146_double_box2.jpg,1113,1166,248,295,N,P,test,53,47,2491,si,Verde
265,N_P_Trabajando_Verdes_155_double_box1.jpg,959,1009,229,279,N,P,test,50,50,2500,si,Verde
266,N_P_Trabajando_Verdes_155_double_box2.jpg,1045,1109,243,290,N,P,test,64,47,3008,si,Verde
267,N_P_Trabajando_Verdes_164_single_box.jpg,1060,1113,252,294,N,P,test,53,42,2226,si,Verde
268,N_P_Trabajando_Verdes_173_single_box.jpg,1023,1081,235,278,N,P,test,58,43,2494,si,Verde
269,N_P_Trabajando_Verdes_182_single_box.jpg,1026,1093,256,310,N,P,test,67,54,3618,si,Verde
270,N_P_Trabajando_Verdes_20_double_box1.jpg,966,1021,250,306,N,P,train,55,56,3080,si,Verde
271,N_P_Trabajando_Verdes_20_double_box2.jpg,1025,1092,245,302,N,P,train,67,57,3819,si,Verde
272,N_P_Trabajando_Verdes_30_single_box.jpg,965,1023,255,310,N,P,train,58,55,3190,si,Verde
273,N_P_Trabajando_Verdes_40_single_box.jpg,1066,1122,242,285,N,P,train,56,43,2408,si,Verde
274,N_P_Trabajando_Verdes_50_single_box.jpg,1102,1149,236,278,N,P,train,47,42,1974,si,Verde
275,N_P_Trabajando_Verdes_60_double_box1.jpg,976,1035,252,296,N,P,train,59,44,2596,si,Verde
276,N_P_Trabajando_Verdes_60_double_box2.jpg,1045,1099,250,305,N,P,train,54,55,2970,si,Verde
277,N_P_Trabajando_Verdes_70_double_box1.jpg,988,1048,249,296,N,P,train,60,47,2820,si,Verde
278,N_P_Trabajando_Verdes_70_double_box2.jpg,1081,1138,189,242,N,P,train,57,53,3021,si,Verde
279,N_P_Trabajando_Verdes_80_double_box1.jpg,963,1034,255,308,N,P,train,71,53,3763,si,Verde
280,N_P_Trabajando_Verdes_80_double_box2.jpg,1045,1099,236,270,N,P,train,54,34,1836,si,Verde
281,N_P_Trabajando_Verdes_90_double_box1.jpg,1066,1113,232,279,N,P,train,47,47,2209,si,Verde
282,N_P_Trabajando_Verdes_90_double_box2.jpg,1009,1063,233,282,N,P,train,54,49,2646,si,Verde
283,T_G_Mostrando_Verdes_0_double_box1.jpg,808,976,265,392,T,G,train,168,127,21336,si,Verde
284,T_G_Mostrando_Verdes_0_double_box2.jpg,977,1180,274,405,T,G,train,203,131,26593,si,Verde
285,T_G_Mostrando_Verdes_10_double_box1.jpg,526,665,311,483,T,G,train,139,172,23908,si,Verde
286,T_G_Mostrando_Verdes_10_double_box2.jpg,1284,1433,369,528,T,G,train,149,159,23691,si,Verde
287,T_G_Mostrando_Verdes_100_double_box1.jpg,934,1178,122,261,T,G,test,244,139,33916,si,Verde
288,T_G_Mostrando_Verdes_100_double_box2.jpg,795,951,147,247,T,G,test,156,100,15600,si,Verde
289,T_G_Mostrando_Verdes_110_double_box1.jpg,989,1159,191,287,T,G,test,170,96,16320,si,Verde
290,T_G_Mostrando_Verdes_110_double_box2.jpg,834,1004,188,295,T,G,test,170,107,18190,si,Verde
291,T_G_Mostrando_Verdes_19_double_box1.jpg,572,760,612,855,T,G,train,188,243,45684,si,Verde
292,T_G_Mostrando_Verdes_19_double_box2.jpg,962,1155,685,895,T,G,train,193,210,40530,si,Verde
293,T_G_Mostrando_Verdes_25_double_box1.jpg,1022,1194,629,839,T,G,train,172,210,36120,si,Verde
294,T_G_Mostrando_Verdes_25_double_box2.jpg,671,830,574,781,T,G,train,159,207,32913,si,Verde
295,T_G_Mostrando_Verdes_33_double_box1.jpg,1068,1284,550,724,T,G,train,216,174,37584,si,Verde
296,T_G_Mostrando_Verdes_33_double_box2.jpg,573,745,488,731,T,G,train,172,243,41796,si,Verde
297,T_G_Mostrando_Verdes_45_double_box1.jpg,627,771,258,402,T,G,train,144,144,20736,si,Verde
298,T_G_Mostrando_Verdes_45_double_box2.jpg,1067,1244,274,419,T,G,train,177,145,25665,si,Verde
299,T_G_Mostrando_Verdes_54_double_box1.jpg,477,649,536,768,T,G,train,172,232,39904,si,Verde
300,T_G_Mostrando_Verdes_54_double_box2.jpg,1262,1429,605,817,T,G,train,167,212,35404,si,Verde
301,T_G_Mostrando_Verdes_65_double_box1.jpg,337,631,628,908,T,G,train,294,280,82320,si,Verde
302,T_G_Mostrando_Verdes_65_double_box2.jpg,1424,1688,620,853,T,G,train,264,233,61512,si,Verde
303,T_G_Mostrando_Verdes_75_double_box1.jpg,1249,1501,426,649,T,G,train,252,223,56196,si,Verde
304,T_G_Mostrando_Verdes_75_double_box2.jpg,521,716,411,644,T,G,train,195,233,45435,si,Verde
305,T_G_Mostrando_Verdes_89_double_box1.jpg,1131,1283,338,468,T,G,test,152,130,19760,si,Verde
306,T_G_Mostrando_Verdes_89_double_box2.jpg,677,830,302,429,T,G,test,153,127,19431,si,Verde
307,T_G_Mostrando_Verdes_92_double_box1.jpg,795,943,270,392,T,G,test,148,122,18056,si,Verde
308,T_G_Mostrando_Verdes_92_double_box2.jpg,985,1151,287,401,T,G,test,166,114,18924,si,Verde
309,T_G_Trabajando_Verdes_0_double_box1.jpg,838,1098,262,476,T,G,train,260,214,55640,si,Verde
310,T_G_Trabajando_Verdes_0_double_box2.jpg,484,688,222,424,T,G,train,204,202,41208,si,Verde
311,T_G_Trabajando_Verdes_10_double_box1.jpg,724,922,71,225,T,G,train,198,154,30492,si,Verde
312,T_G_Trabajando_Verdes_10_double_box2.jpg,859,1070,559,973,T,G,train,211,414,87354,si,Verde
313,T_G_Trabajando_Verdes_100_double_box1.jpg,1496,1694,301,454,T,G,train,198,153,30294,si,Verde
314,T_G_Trabajando_Verdes_100_double_box2.jpg,1267,1522,481,665,T,G,train,255,184,46920,si,Verde
315,T_G_Trabajando_Verdes_116_double_box1.jpg,824,1085,419,627,T,G,test,261,208,54288,si,Verde
316,T_G_Trabajando_Verdes_116_double_box2.jpg,740,900,278,447,T,G,test,160,169,27040,si,Verde
317,T_G_Trabajando_Verdes_124_double_box1.jpg,891,1142,435,679,T,G,test,251,244,61244,si,Verde
318,T_G_Trabajando_Verdes_124_double_box2.jpg,1242,1365,459,726,T,G,test,123,267,32841,si,Verde
319,T_G_Trabajando_Verdes_134_single_box.jpg,683,887,325,456,T,G,test,204,131,26724,si,Verde
320,T_G_Trabajando_Verdes_146_double_box1.jpg,1472,1641,359,537,T,G,test,169,178,30082,si,Verde
321,T_G_Trabajando_Verdes_146_double_box2.jpg,1147,1390,347,612,T,G,test,243,265,64395,si,Verde
322,T_G_Trabajando_Verdes_151_double_box1.jpg,1031,1172,308,397,T,G,test,141,89,12549,si,Verde
323,T_G_Trabajando_Verdes_151_double_box2.jpg,833,936,304,401,T,G,test,103,97,9991,si,Verde
324,T_G_Trabajando_Verdes_20_double_box1.jpg,1131,1310,413,704,T,G,train,179,291,52089,si,Verde
325,T_G_Trabajando_Verdes_20_double_box2.jpg,797,946,449,662,T,G,train,149,213,31737,si,Verde
326,T_G_Trabajando_Verdes_30_double_box1.jpg,854,1031,299,519,T,G,train,177,220,38940,si,Verde
327,T_G_Trabajando_Verdes_30_double_box2.jpg,1175,1281,300,520,T,G,train,106,220,23320,si,Verde
328,T_G_Trabajando_Verdes_40_single_box.jpg,341,468,310,571,T,G,train,127,261,33147,si,Verde
329,T_G_Trabajando_Verdes_50_double_box1.jpg,908,1059,308,533,T,G,train,151,225,33975,si,Verde
330,T_G_Trabajando_Verdes_50_double_box2.jpg,1089,1220,313,538,T,G,train,131,225,29475,si,Verde
331,T_G_Trabajando_Verdes_60_double_box1.jpg,739,889,255,414,T,G,train,150,159,23850,si,Verde
332,T_G_Trabajando_Verdes_60_double_box2.jpg,943,1102,297,503,T,G,train,159,206,32754,si,Verde
333,T_G_Trabajando_Verdes_70_single_box.jpg,849,1105,158,374,T,G,train,256,216,55296,si,Verde
334,T_G_Trabajando_Verdes_80_double_box1.jpg,1006,1155,305,493,T,G,train,149,188,28012,si,Verde
335,T_G_Trabajando_Verdes_80_double_box2.jpg,725,880,229,352,T,G,train,155,123,19065,si,Verde
336,T_G_Trabajando_Verdes_91_double_box1.jpg,984,1210,444,648,T,G,train,226,204,46104,si,Verde
337,T_G_Trabajando_Verdes_91_double_box2.jpg,827,1067,86,226,T,G,train,240,140,33600,si,Verde
338,T_P_Mostrando_Verdes_0_double_box1.jpg,1254,1318,249,294,T,P,train,64,45,2880,si,Verde
339,T_P_Mostrando_Verdes_0_double_box2.jpg,1174,1235,255,296,T,P,train,61,41,2501,si,Verde
340,T_P_Mostrando_Verdes_10_double_box1.jpg,1090,1152,259,317,T,P,train,62,58,3596,si,Verde
341,T_P_Mostrando_Verdes_10_double_box2.jpg,1310,1383,275,328,T,P,train,73,53,3869,si,Verde
342,T_P_Mostrando_Verdes_100_single_box.jpg,1618,1680,1,67,T,P,train,62,66,4092,si,Verde
343,T_P_Mostrando_Verdes_111_double_box1.jpg,1460,1503,287,343,T,P,train,43,56,2408,si,Verde
344,T_P_Mostrando_Verdes_111_double_box2.jpg,1592,1659,301,351,T,P,train,67,50,3350,si,Verde
345,T_P_Mostrando_Verdes_112_double_box1.jpg,1435,1482,244,303,T,P,test,47,59,2773,si,Verde
346,T_P_Mostrando_Verdes_112_double_box2.jpg,1607,1674,272,325,T,P,test,67,53,3551,si,Verde
347,T_P_Mostrando_Verdes_130_single_box.jpg,1140,1202,33,104,T,P,test,62,71,4402,si,Verde
348,T_P_Mostrando_Verdes_140_double_box1.jpg,935,992,66,131,T,P,test,57,65,3705,si,Verde
349,T_P_Mostrando_Verdes_140_double_box2.jpg,1054,1122,80,140,T,P,test,68,60,4080,si,Verde
350,T_P_Mostrando_Verdes_150_double_box1.jpg,1072,1137,5,71,T,P,test,65,66,4290,si,Verde
351,T_P_Mostrando_Verdes_150_double_box2.jpg,916,980,1,60,T,P,test,64,59,3776,si,Verde
352,T_P_Mostrando_Verdes_157_single_box.jpg,1146,1190,196,252,T,P,test,44,56,2464,si,Verde
353,T_P_Mostrando_Verdes_20_double_box1.jpg,1058,1138,75,160,T,P,train,80,85,6800,si,Verde
354,T_P_Mostrando_Verdes_20_double_box2.jpg,1354,1430,104,184,T,P,train,76,80,6080,si,Verde
355,T_P_Mostrando_Verdes_30_single_box.jpg,1138,1191,249,285,T,P,train,53,36,1908,si,Verde
356,T_P_Mostrando_Verdes_31_double_box1.jpg,1072,1122,236,281,T,P,train,50,45,2250,si,Verde
357,T_P_Mostrando_Verdes_31_double_box2.jpg,1354,1402,253,292,T,P,train,48,39,1872,si,Verde
358,T_P_Mostrando_Verdes_40_double_box1.jpg,1159,1215,279,319,T,P,train,56,40,2240,si,Verde
359,T_P_Mostrando_Verdes_40_double_box2.jpg,1251,1308,279,323,T,P,train,57,44,2508,si,Verde
360,T_P_Mostrando_Verdes_50_double_box1.jpg,1186,1234,241,291,T,P,train,48,50,2400,si,Verde
361,T_P_Mostrando_Verdes_50_double_box2.jpg,1247,1303,252,296,T,P,train,56,44,2464,si,Verde
362,T_P_Mostrando_Verdes_60_double_box1.jpg,1166,1215,251,309,T,P,train,49,58,2842,si,Verde
363,T_P_Mostrando_Verdes_60_double_box2.jpg,1240,1304,259,313,T,P,train,64,54,3456,si,Verde
364,T_P_Mostrando_Verdes_70_double_box1.jpg,1087,1130,269,315,T,P,train,43,46,1978,si,Verde
365,T_P_Mostrando_Verdes_70_double_box2.jpg,1359,1410,277,316,T,P,train,51,39,1989,si,Verde
366,T_P_Mostrando_Verdes_80_double_box1.jpg,1086,1151,54,138,T,P,train,65,84,5460,si,Verde
367,T_P_Mostrando_Verdes_80_double_box2.jpg,1339,1403,83,150,T,P,train,64,67,4288,si,Verde
368,T_P_Mostrando_Verdes_90_double_box1.jpg,1360,1426,65,149,T,P,train,66,84,5544,si,Verde
369,T_P_Mostrando_Verdes_90_double_box2.jpg,1179,1264,50,121,T,P,train,85,71,6035,si,Verde
370,T_P_Trabajando_Verdes_0_single_box.jpg,1179,1262,218,281,T,P,train,83,63,5229,si,Verde
371,T_P_Trabajando_Verdes_10_double_box1.jpg,1085,1159,234,303,T,P,train,74,69,5106,si,Verde
372,T_P_Trabajando_Verdes_10_double_box2.jpg,1204,1271,245,310,T,P,train,67,65,4355,si,Verde
373,T_P_Trabajando_Verdes_100_double_box1.jpg,1110,1162,198,267,T,P,train,52,69,3588,si,Verde
374,T_P_Trabajando_Verdes_100_double_box2.jpg,1384,1444,247,299,T,P,train,60,52,3120,si,Verde
375,T_P_Trabajando_Verdes_110_double_box1.jpg,1125,1198,202,269,T,P,train,73,67,4891,si,Verde
376,T_P_Trabajando_Verdes_110_double_box2.jpg,1356,1420,208,257,T,P,train,64,49,3136,si,Verde
377,T_P_Trabajando_Verdes_120_double_box1.jpg,1164,1215,239,299,T,P,train,51,60,3060,si,Verde
378,T_P_Trabajando_Verdes_120_double_box2.jpg,1231,1287,231,289,T,P,train,56,58,3248,si,Verde
379,T_P_Trabajando_Verdes_130_single_box.jpg,1153,1211,233,296,T,P,train,58,63,3654,si,Verde
380,T_P_Trabajando_Verdes_140_double_box1.jpg,1111,1202,220,291,T,P,train,91,71,6461,si,Verde
381,T_P_Trabajando_Verdes_140_double_box2.jpg,1044,1099,209,251,T,P,train,55,42,2310,si,Verde
382,T_P_Trabajando_Verdes_150_double_box1.jpg,1259,1311,248,301,T,P,train,52,53,2756,si,Verde
383,T_P_Trabajando_Verdes_150_double_box2.jpg,1331,1375,249,293,T,P,train,44,44,1936,si,Verde
384,T_P_Trabajando_Verdes_160_single_box.jpg,1244,1298,201,255,T,P,train,54,54,2916,si,Verde
385,T_P_Trabajando_Verdes_170_double_box1.jpg,1288,1338,213,256,T,P,train,50,43,2150,si,Verde
386,T_P_Trabajando_Verdes_170_double_box2.jpg,1236,1286,219,261,T,P,train,50,42,2100,si,Verde
387,T_P_Trabajando_Verdes_172_double_box1.jpg,1291,1332,214,252,T,P,test,41,38,1558,si,Verde
388,T_P_Trabajando_Verdes_172_double_box2.jpg,1234,1280,218,254,T,P,test,46,36,1656,si,Verde
389,T_P_Trabajando_Verdes_182_single_box.jpg,1211,1262,222,283,T,P,test,51,61,3111,si,Verde
390,T_P_Trabajando_Verdes_196_double_box1.jpg,1143,1186,235,295,T,P,test,43,60,2580,si,Verde
391,T_P_Trabajando_Verdes_196_double_box2.jpg,1216,1275,245,292,T,P,test,59,47,2773,si,Verde
392,T_P_Trabajando_Verdes_20_single_box.jpg,1131,1187,223,277,T,P,train,56,54,3024,si,Verde
393,T_P_Trabajando_Verdes_204_single_box.jpg,1241,1328,181,232,T,P,test,87,51,4437,si,Verde
394,T_P_Trabajando_Verdes_211_double_box1.jpg,1212,1267,265,311,T,P,test,55,46,2530,si,Verde
395,T_P_Trabajando_Verdes_211_double_box2.jpg,1284,1335,256,300,T,P,test,51,44,2244,si,Verde
396,T_P_Trabajando_Verdes_220_single_box.jpg,1138,1207,201,253,T,P,test,69,52,3588,si,Verde
397,T_P_Trabajando_Verdes_230_single_box.jpg,1249,1294,211,248,T,P,test,45,37,1665,si,Verde
398,T_P_Trabajando_Verdes_240_double_box1.jpg,1214,1261,200,245,T,P,test,47,45,2115,si,Verde
399,T_P_Trabajando_Verdes_240_double_box2.jpg,1247,1286,236,276,T,P,test,39,40,1560,si,Verde
400,T_P_Trabajando_Verdes_30_single_box.jpg,1164,1225,222,276,T,P,train,61,54,3294,si,Verde
401,T_P_Trabajando_Verdes_40_single_box.jpg,1164,1203,196,272,T,P,train,39,76,2964,si,Verde
402,T_P_Trabajando_Verdes_50_single_box.jpg,1170,1223,224,265,T,P,train,53,41,2173,si,Verde
403,T_P_Trabajando_Verdes_60_single_box.jpg,1113,1169,227,286,T,P,train,56,59,3304,si,Verde
404,T_P_Trabajando_Verdes_70_double_box1.jpg,1312,1355,240,290,T,P,train,43,50,2150,si,Verde
405,T_P_Trabajando_Verdes_70_double_box2.jpg,1245,1295,239,284,T,P,train,50,45,2250,si,Verde
406,T_P_Trabajando_Verdes_80_double_box1.jpg,1194,1243,207,255,T,P,train,49,48,2352,si,Verde
407,T_P_Trabajando_Verdes_80_double_box2.jpg,1308,1354,260,301,T,P,train,46,41,1886,si,Verde
408,T_P_Trabajando_Verdes_90_single_box.jpg,1303,1359,243,295,T,P,train,56,52,2912,si,Verde
